网	MQQI
易	JQRR
公	WCU
司	NGKD
版	THGC
权	SCY
所	RNRH
有	DEF
标	SFIY
题	JGHM
滚	IUCE
动	FCLN
图	LTUI
集	WYSU
本	SGD
共	AWU
张	XTAY
片	THGN
中	KHK
超	FHVK
第	TXHT
轮	LWXN
西	SGHG
安	PVF
国	LGYI
际	BFIY
大	DDDD
连	LPK
实	PUDU
德	TFLN
日	JJJJ
期	ADWE
圈	LUDB
内	MWI
更	GJQI
多	QQU
博	FGEF
文	YYGY
加	LKG
载	FALK
签	TWGI
回	LKD
复	TJTU
评	YGUH
论	YWXN
页	DMU
东	AII
华	WXFJ
学	IPBF
薛	AWNU
志	FNU
强	XKJY
体	WSGG
育	YCEF
昨	JTHF
在	DHFD
股	EMCY
指	RXJG
早	JHNH
盘	TELF
继	XONN
续	XFND
幅	MHGL
落	AITK
并	UAJ
迅	NFPK
速	GKIP
逼	GKLP
近	RPK
点	HKOU
的	RQYY
时	JFY
候	WHND
石	DGTG
化	WXN
油	IMG
和	TKG
电	JNV
力	LTN
板	SRCY
块	FNWY
擎	AQKR
起	FHNV
旗	YTAW
那	VFBH
么	TCU
它	PXB
们	WUN
飙	DDDQ
升	TAK
何	WSKG
呢	KNXN
众	WWWU
周	MFKD
知	TDKG
因	LDI
为	YLYI
上	HHGG
游	IYTB
成	DNNT
不	GII
断	ONRH
涨	IXTY
价	WWJH
压	DFYI
使	WGKQ
得	TJGF
行	TFHH
业	OGD
面	DMJD
临	JTYJ
着	UDHF
全	WGF
困	LSI
境	FUJQ
负	QMU
影	JYIE
响	KTMK
下	GHI
以	NYWY
收	NHTY
市	YMHJ
一	GGLL
季	TBF
度	YACI
绩	XGMY
计	YFH
算	THAJ
盈	ECLF
率	YXIF
水	IIII
平	GUHK
沪	IYNT
深	IPWS
场	FNRT
总	UKNU
分	WVB
别	KLJH
倍	WUKG
比	XXN
值	WFHG
前	UEJJ
台	CKF
相	SHG
由	MHNG
于	GFK
利	TJH
环	GGIY
而	DMJJ
导	NFU
致	GCFT
润	IUGG
滑	IMEG
直	FHF
接	RUVG
了	BNH
蓝	AJTL
筹	TDTF
对	CFY
估	WDG
此	HXN
目	HHHH
发	NTCY
反	RCI
弹	XUJF
情	NGEG
具	HWU
备	TLF
类	ODU
似	WNYW
自	THD
身	TMDT
条	TSU
件	WRHH
也	BNHN
就	YIDN
是	JGHU
说	YUKQ
外	QHY
作	WTHF
用	ETNH
笔	TTFN
者	FTJF
认	YWY
两	GMWW
个	WHJ
可	SKD
能	CEXX
种	TKHH
品	KKKF
预	CBDM
这	YPI
将	UQFY
好	VBG
关	UDU
但	WJGG
部	UKBH
微	TMGT
乎	TUHK
其	ADWU
地	FBN
震	FDFE
已	NNNN
经	XCAG
剧	NDJH
半	UFK
年	RHFK
如	VKG
果	JSI
管	TPNN
理	GJFG
层	NFCI
抑	RQBH
制	RMHJ
通	CEPK
胀	ETAY
保	WKSY
济	IYJH
增	FULJ
长	TAYI
之	PPPP
间	UJD
选	TFQP
择	RCFH
后	RGKD
意	UJNU
味	KFIY
未	FII
来	GOI
当	IVF
段	WDMC
高	YMKF
贯	XFMU
穿	PWAT
重	TGJF
要	SVF
主	YGD
性	NTGG
必	NTE
然	QDOU
受	EPCU
到	GCFJ
损	RKMY
失	RWI
走	FHU
势	RVYL
言	YYYY
二	FGG
护	RYNT
举	IWFH
突	PWDU
爆	OJAI
原	DRII
述	SYPI
较	LUQY
小	IHTY
些	HXFF
出	BMK
现	GMQN
巨	AND
政	GHTY
府	YWFI
给	XWGK
予	CBJ
适	TDPD
财	MFTT
补	PUHY
贴	MHKG
倒	WGCJ
很	TVEY
亏	FNV
弥	XQIY
杯	SGIY
车	LGNH
薪	AUSR
潜	IFWJ
话	YTDG
缺	RMNW
乏	TPI
持	RFFY
支	FCU
会	WFCU
从	WWY
形	GAET
定	PGHU
样	SUDH
否	GIKF
效	UQTY
看	RHF
表	GEU
信	WYG
达	DPI
证	YGHG
券	UDVB
马	CNNG
佳	WFFG
颖	XTDM
新	USRH
浪	IYVE
声	FNR
明	JEG
章	UJJ
容	PWWK
纯	XGBN
属	NTKY
人	WWWW
观	CMQN
仅	WCY
供	WAWY
投	RMCY
资	UQWM
参	CDER
考	FTGN
构	SQCY
建	VFHP
议	YYQY
据	RNDG
操	RKKS
风	MQI
险	BWGI
担	RJGG
编	XYNA
辑	LKBG
王	GGGG
亚	GOGD
男	LLB
空	PWAF
拖	RTBN
累	LXIU
豆	GKUF
货	WXMU
低	WQAY
月	EEEE
最	JBCU
美	UGDU
跌	KHRW
合	WGKF
约	XQYY
析	SRH
师	JGMH
称	TQIY
金	QQQQ
软	LQWY
及	EYI
元	FQB
坚	JCFF
挺	RTFP
奠	USGD
商	UMWK
整	GKIH
调	YMFK
基	ADWF
交	UQU
心	NYNY
遭	GMAP
遇	JMHP
末	GSI
获	AQTD
仓	WBB
阿	BSKG
根	SVEY
廷	TFPD
罢	LFCU
工	AAAA
谈	YOOY
判	UDJH
破	DHCY
裂	GQJE
消	IIEG
息	THNU
撑	RIPR
过	FPI
隔	BGKH
夜	YWTY
显	JOGF
天	GDI
气	RNB
报	RBCY
示	FIU
物	TRQR
带	GKPH
恢	NDOY
温	IJLG
暖	JEFC
干	FGGH
燥	OKKS
播	RTOL
苗	ALF
生	TGD
机	SMN
卖	FNUD
弱	XUXU
远	FQPV
缩	XPWJ
量	JGJF
减	UDGT
互	GXGD
吨	KGBN
少	ITR
手	RTGH
万	DNV
方	YYGN
向	TMKD
普	UOGJ
遍	YNMP
却	FCBH
又	CCCC
敢	NBTY
贸	QYVM
抛	RVLN
盾	RFHD
短	TDGU
线	XGT
流	IYCQ
绫	XFWT
乱	TDNN
初	PUVN
探	RPWS
荡	AINR
拉	RUG
子	BBBB
劲	CALN
且	EGD
进	FJPK
步	HIR
修	WHTE
正	GHD
与	GNGD
差	UDAF
求	FIYI
稳	TQVN
降	BTAH
仍	WEN
追	WNNP
愿	DRIN
头	UDI
伤	WTLN
逐	EPI
归	JVG
吐	KFG
忽	QRNU
视	PYMQ
令	WYCU
再	GMFD
次	UQWY
验	CWGI
位	WUG
迹	YOPI
象	QJEU
恐	AMYN
引	XHH
领	WYCM
顺	KDMY
今	WYNB
开	GAK
介	WJJ
入	TYI
或	AKGD
买	NUDU
粕	ORG
套	DDU
广	YYGT
袁	FKEU
健	WVFP
斌	YGAH
攀	SQQR
耗	DITN
问	UKD
族	YTTD
病	UGMW
各	TKF
节	ABJ
产	UTE
打	RSH
省	ITHF
牌	THGF
杀	QSU
记	YNN
查	SJGF
销	QIEG
售	WYKF
繁	TXGI
功	ALN
良	YVEI
莠	ATEB
齐	YJJ
采	ESU
访	YYN
士	FGHG
做	WDTY
番	TOLF
真	FHWU
假	WNHC
难	CWYG
辨	UYTU
四	LHNG
汽	IRNN
配	SGNN
城	FDNT
眼	HVEY
花	AWXB
缭	XDUI
添	IGDN
剂	YJJH
器	KKDK
三	DGGG
家	PEU
映	JMDY
包	QNV
括	RTDG
便	WGJQ
欢	CQWY
迎	QBPK
号	KGNB
厅	DSK
精	OGEG
店	YHKD
费	XJMU
份	WWVN
询	YQJG
格	STKG
拿	WGKR
热	RVYO
推	RWYG
荐	ADHB
注	IYGG
几	MTN
十	FGH
百	DJF
等	TFFU
解	QEVH
清	IGEG
洁	IFKG
喷	KFAM
射	TMDF
系	TXIU
统	XYCQ
燃	OQDO
路	KHTK
溶	IPWK
胶	EUQY
状	UDY
他	WBN
沉	IPMN
积	TKWY
杂	VSU
质	RFMI
改	NTY
善	UDUK
提	RJGH
装	UFYE
无	FQV
没	IMCY
我	TRNT
检	SWGI
伪	WYLY
己	NNGN
承	BDII
存	DHBD
都	FTJB
鱼	QGF
龙	DXV
混	IJXX
研	DGAH
究	PWVB
院	BPFQ
还	GIPI
针	QFH
准	UWYG
确	DQEH
购	MQCY
尽	NYUU
厂	DGT
专	FNYI
渠	IANS
道	UTHP
辆	LGMW
造	TFKP
害	PDHK
兴	IWU
丰	DHK
田	LLLL
服	EBCY
务	TLB
江	IAG
勇	CELB
醒	SGJG
防	BYN
止	HHHG
冒	JHF
劣	ITLB
坏	FGIY
则	MJH
享	YBF
诺	YADK
冷	UWYC
疑	XTDH
随	BDEP
事	GKVH
刘	YJH
先	TFQB
讲	YFJH
朋	EEG
友	DCU
历	DLV
置	LFHF
纳	XMWY
米	OYTY
技	RFCY
术	SYI
促	WKHY
缸	RMAG
充	YCQB
完	PFQB
烧	OATQ
乐	QII
像	WQJE
宣	PGJG
传	WFNY
宝	PGYU
甚	ADWN
至	GCFF
千	TFK
虑	HANI
排	RDJD
驾	LKCF
驶	CKQY
习	NUD
惯	NXFM
联	BUDY
偿	WIPC
望	YNEG
太	DYI
协	FLWY
养	UDYJ
非	DJDD
材	SFTT
料	OUFH
组	XEGG
数	OVTY
般	TEMC
态	DYNU
轻	LCAG
奥	TMOD
迪	MPD
代	WAY
库	YLK
坛	FFCY
始	VCKG
涡	IKMW
程	TKGG
卡	HHU
柴	HXSU
应	YID
轿	LTDJ
极	SEYY
秋	TOY
法	IFCY
兰	UFF
克	DQB
福	PYGL
展	NAEI
被	PUHC
划	AJH
首	UTHF
世	ANV
界	LWJJ
独	QTJY
铝	QKKG
豪	YPEU
型	GAJF
换	RQMD
同	MGKD
凡	MYI
列	GQJH
奖	UQDU
契	DHVD
命	WGKB
名	QKF
级	XEYY
底	YQAY
尾	NTFN
灯	OSH
设	YMCY
争	QVHJ
依	WYEY
取	BCY
骄	CTDJ
北	UXN
口	KKKK
项	ADMY
六	UYGY
瓦	GNYN
亮	YPMB
式	AAD
尺	NYI
寸	FGHY
宽	PAMQ
轴	LMG
距	KHAN
阴	BEG
科	TUFH
房	YNYV
曾	ULJF
活	ITDG
跃	KHTD
榜	SUPY
只	KWU
票	SFIU
停	WYPS
除	BWTY
波	IHCY
创	WBJH
测	IMJH
仪	WYQY
见	MQB
均	FQUG
严	GODR
优	WDNN
边	LPV
捧	RDWH
待	TFFY
察	PWFI
谨	YAKG
慎	NFHW
夺	DFU
召	VKF
偏	WYNA
山	MMMM
药	AXQY
玻	GHCY
足	KHU
医	ATDI
每	TXGU
益	UWLF
璃	GYBC
额	PTKM
居	NDD
规	FWMQ
模	SAJD
洲	IYTH
细	XLG
左	DAF
右	DKF
竞	UKQB
欧	AQQW
盟	JELF
呈	KGF
垄	DXFF
该	YYNW
溢	IUWL
例	WGQJ
即	VCBH
禁	SSFI
码	DCG
趋	FHQV
占	HKF
助	EGLN
结	XFKG
端	UMDJ
靠	TFKD
拢	RDXN
亿	WNN
档	SIVG
灌	IAKY
封	FFFY
瓶	UAGN
需	FDMJ
去	FCU
掌	IPKR
握	RNGF
企	WHF
唯	KWYG
蓄	AYXL
阳	BJG
逆	UBTP
放	YTY
攻	ATY
按	RPVG
截	FAWY
站	UHKG
桶	SCEH
音	UJF
试	YAAG
寻	VFU
释	TOCH
贬	MTPY
汇	IAN
变	YOCU
币	TMHK
素	GXIU
俄	WTRT
罗	LQU
斯	ADWR
递	UXHP
源	IDRI
域	FAKG
官	PNHN
英	AMDU
融	GKMJ
束	GKII
越	FHAT
峰	MTDH
球	GFIY
想	SHNU
快	NNWY
顶	SDMY
冲	UKHH
击	FMK
另	KLB
尔	QIU
街	TFFH
署	LFTJ
巴	CNHN
黎	TQTI
况	UKQN
才	FTE
布	DMHJ
常	IPKH
楚	SSNH
紧	JCXI
启	YNKD
聚	BCTI
焦	WYOU
顾	DBDM
徐	TWTY
杰	SOU
团	LFTE
范	AIBB
教	FTBT
授	REPC
莱	AGOU
詹	QDWY
姆	VXGU
贝	MHNY
客	PTKF
座	YWWF
员	KMU
委	TVF
著	AFTJ
纪	XNN
缘	XXEY
治	ICKG
崛	MNBM
译	YCFH
沙	IITT
漠	IAJD
黄	AMWU
昏	QAJF
特	TRFF
危	QDBB
书	NNHY
蒙	APGE
揭	RJQN
神	PYJH
秘	TNTT
纱	XITT
读	YFND
讨	YFY
键	QVFP
请	YGEG
你	WQIY
什	WFH
思	LNU
离	YBMC
谓	YLEG
决	UNWY
媒	VAFS
感	DGKN
觉	IPMQ
晰	JSRH
静	GEQH
哪	KVFB
运	FCPI
输	LWGJ
角	QEJ
衡	TQDH
怎	THFN
诸	YFTJ
限	BVEY
债	WGMY
净	UQVH
兼	UVOU
障	BUJH
绪	XFTJ
双	CCY
馈	QNKM
立	UUUU
础	DBMH
色	QCB
农	PEI
招	RVKG
京	YIU
银	QVEY
圳	FKH
泓	IXCY
责	GMU
任	WTFG
陈	BAIY
墨	LFOF
讯	YNFH
告	TFKF
策	TGMI
略	LTKG
暂	LRJF
申	JHK
转	LFNY
赎	MFND
照	JVKO
办	LWI
悉	TONU
蟑	JUJH
畅	JHNR
凯	MNMN
誉	IWYF
颇	HCDM
拔	RDCY
萃	AYWF
敞	IMKT
舒	WFKB
乘	TUXV
坐	WWFF
椅	SDSK
灵	VOU
款	FFIW
俱	WHWY
乒	RGTR
赛	PFJM
女	VVVV
队	BWY
白	RRRR
钮	QNFG
午	TFJ
靓	GEMQ
听	KRH
歌	SKSW
悄	NIEG
南	FMUF
汶	IYY
川	KTHH
杏	SKF
移	TQQY
幸	FUFJ
她	VBN
赶	FHFK
秀	TEB
疗	UBK
送	UDPI
礼	PYNN
杨	SNRT
坤	FJHH
宋	PSU
祖	PYEG
郎	YVCB
朗	YVCE
星	JTGF
贺	LKMU
孩	BYNW
航	TEYM
呆	KSU
默	LFOD
闻	UBD
绵	XRMH
灾	POU
区	AQI
携	RWYE
画	GLBJ
描	RALG
纸	XQAN
急	QVNU
儿	QTN
校	SUQY
曲	MAD
童	UJFF
希	QDMH
劫	FCLN
彩	ESET
瞬	HEPH
幻	XNN
秒	TITT
烨	OWXF
艾	AQU
轩	LFH
摄	RBCC
青	GEF
莲	ALPU
免	QKQB
冠	PFQF
军	PLJ
辅	LGEY
戴	FALW
里	JFD
昂	JQBJ
错	QAJG
误	YKGD
帖	MHHK
审	PJHJ
核	SYNW
阅	UUKQ
耐	DMJF
您	WQIN
录	VIU
戛	DHAR
森	SSSU
尤	DNV
挑	RIQN
战	HKAT
综	XPFI
籁	TGKM
脱	EUKQ
胎	ECKG
骨	MEF
驱	CAQY
侧	WMJH
舱	TEWB
仿	WYN
副	GKLJ
席	YAMH
腿	EVEP
枕	SPQN
裹	YJSE
娱	VKGD
景	JYIU
窗	PWTQ
绕	XATQ
绝	XQCN
许	YTFH
娇	VTDJ
逍	IEPD
跨	KHDN
终	XTUY
户	YNE
海	ITXU
永	YNII
营	APKK
武	GAHD
汉	ICY
旅	YTEY
甲	LHNH
柏	SRG
林	SSY
赫	FOFO
塔	FAWK
门	UYHN
栏	SUFG
聘	BMGN
韩	FJFH
念	WYNN
毕	XXFJ
艺	ANB
凤	MCI
演	IPGW
勋	KMLN
彬	SSET
俊	WCWT
允	CQB
浩	ITFK
晟	JDNT
敏	TXGT
庚	YVWI
乡	XTE
迷	OPI
够	QKQQ
郑	UDBH
糖	OYVK
宁	PSJ
柳	SQTB
州	YTYH
宾	PRGW
淡	IOOY
贵	KHGM
港	IAWN
塞	PFJF
缪	XNWE
曼	JLCU
储	WYFJ
唐	YVHK
笑	TTDU
晚	JQKQ
湖	IDEG
卫	BGD
香	TJF
舞	RLGH
奇	DSKF
淘	IQRM
汰	IDYY
激	IRYT
单	UJFJ
姓	VTGG
孙	BIY
刻	YNTJ
住	WYGG
处	THI
胜	ETGG
咨	UQWK
捐	RKEG
赠	MULJ
亟	BKCG
霉	FTXU
鲁	QGJF
抗	RYMN
纷	XWVN
囊	GKHE
奉	DWFH
献	FMUD
爱	EPDC
往	TYGG
民	NAV
局	NNKD
晓	JATQ
账	MTAY
透	TEPV
控	RPWA
散	AETY
曝	JJAI
光	IQB
诉	YRYY
把	RCN
派	IREY
阵	BLH
津	IVFH
紫	HXXI
鑫	QQQF
傲	WGQT
肖	IEF
剑	WGIJ
仙	WMH
吴	KGDU
樾	SFHT
忠	KHNU
燕	AUKO
惩	TGHN
罚	LYJJ
勉	QKQL
嘉	FKUK
叶	KFH
伟	WFNH
宇	PGFJ
宗	PFIU
盛	DNNL
甄	SFGN
丹	MYD
栋	SAIY
熊	CEXO
黛	WALO
籍	TDIJ
池	IBN
写	PGNG
富	PGKL
幕	AJDH
匹	AQV
巡	VPV
伴	WUFH
火	OOOO
炬	OANG
辉	IQPL
绿	XVIY
侯	WNTD
咏	KYNI
李	SBF
兆	IQV
郭	YBBH
铭	QQKG
古	DGHG
雁	DWWY
母	XGUI
亲	USU
睛	HGEG
聊	BQTB
红	XAG
字	PBF
拍	RRG
腻	EAFM
娓	VNTN
帮	DTBH
故	DTY
崔	MWYF
雅	AHTY
丽	GMYY
吕	KKF
慧	DHDN
救	FIYT
暨	VCAG
频	HIDM
览	JTYQ
馆	QNPN
葛	AJQN
壮	UFG
秦	DWTU
怡	NCKG
濮	IWOY
昕	JRH
琴	GGWN
娃	VFFG
冰	UIY
陆	BFMH
毅	UEMC
语	YGKG
祝	PYKQ
哲	RRKF
恒	NGJG
逃	IQPV
木	SSSS
忧	NDNN
眉	NHD
跳	KHIQ
摩	YSSR
哥	SKSK
练	XANW
洛	ITKG
迈	DNPV
密	PNTM
顿	GBNM
威	DGVT
廉	YUVO
伯	WRG
社	PYFG
蔡	AWFI
赟	YGAM
付	WFY
拥	REH
抱	RQNN
庆	YDI
印	QGBH
尼	NXV
汤	INRT
羽	NNYG
毛	TFNV
宏	PDCU
晋	GOGJ
磊	DDDF
苏	ALWU
钢	QMQY
篮	TJTL
霸	FAFE
徽	TMGT
肥	ECN
维	XWYG
雷	FLF
旧	HJG
蜂	JTDH
刺	GMIJ
掉	RHJH
蜜	PNTJ
拼	RUAH
啊	KBSK
鄙	KFLB
箭	TUEJ
麦	GTU
避	NKUP
孕	EBF
老	FTXB
伙	WOY
找	RAT
邓	CBH
肯	HEF
句	QKD
赈	MDFE
义	YQI
胡	DEG
慈	UXXN
扶	RFWY
贫	WVMU
援	REFC
凰	MRGD
凝	UXTH
玄	YXU
辽	BPK
涛	IDTF
铁	QRWY
饼	QNUA
径	TCAG
廖	YNWE
届	NMD
董	ATGF
翰	FJWN
桑	CCCS
撼	RDGN
七	AGN
狐	QTRY
谍	YANS
谢	YTMF
君	VTKD
鸿	IAQG
颂	WCDM
贤	JCMU
骆	CTKG
登	WGKU
夫	FWI
骑	CDSK
撒	RAET
丁	SGH
岛	QYNM
雪	FVF
勒	AFLN
沃	ITDY
五	GGHG
跟	KHVE
偶	WJMY
柯	SSKG
毯	TFNO
唱	KJJG
磡	DADL
序	YCBK
惊	NYIY
喜	FKUK
兄	KQB
弟	UXHT
让	YHG
跑	KHQN
爸	WQCB
摇	RERM
群	VTKD
珠	GRIY
翠	NYWF
圆	LKMI
满	IAGW
碧	GRDF
湾	IYOX
杆	SFH
桃	SIQN
园	LFQV
伍	WGG
颁	WVDM
央	MDI
茹	AVKF
衣	YEU
湘	ISHG
蒋	AUQF
康	YVII
土	FFFF
耳	BGHG
伊	WVTT
坦	FJGG
箱	TSHF
萨	ABUT
圣	CFF
渝	IWGJ
班	GYTG
牙	AHTE
留	QYVL
春	DWJF
娜	VVFB
络	XTKG
桥	STDJ
棋	SADW
搜	RVHC
索	FPXI
昌	JJF
镐	QYMK
魔	YSSC
幼	XLN
熙	AHKO
串	KKHK
狠	QTVE
恶	GOGN
搞	RYMK
典	MAWU
恋	YONU
夏	DHTU
窈	PWXL
窕	PWIQ
俏	WIEG
含	WYNK
职	BKWY
绍	XVKG
藏	ADNT
壳	FPMB
蔬	ANHQ
菜	AESU
蘑	AYSD
菇	AVDF
罐	RMAY
饮	QNQW
酒	ISGG
植	SFHG
脂	EXJG
冻	UAIY
猪	QTFJ
肉	MWWI
橡	SQJE
兑	UKQB
阻	BEGG
斤	RTTH
菲	ADJD
竖	JCUF
蒂	AUPH
俞	WGEJ
涯	IDFF
韦	FNHK
茉	AGSU
莉	ATJJ
枚	STY
铜	QMGK
虽	KJU
敌	TDTY
锦	QRMH
涉	IHIT
隆	BTGG
饰	QNTH
曹	GMAJ
貂	EEVK
禅	PYUF
尚	IMKF
泰	DWIU
荷	AWSK
浙	IRRH
滇	IFHW
昆	JXXB
村	SFY
杭	SYMN
鄞	AKGB
庄	YFD
敬	AQKT
谅	YYIY
扎	RNN
剩	TUXJ
悬	EGCN
逊	BIPI
挥	RPLH
久	QYI
违	FNHP
孔	BNN
训	YKH
脚	EFCB
折	RRH
休	WSY
八	WTY
姗	VMMG
迟	NYPI
悍	NJFH
迫	RPD
切	AVN
朝	FJEG
岁	MQU
锋	QTDH
莫	AJDU
埃	FCTD
恩	LDNU
云	FCU
洋	IUDH
矿	DYT
抵	RQAY
澳	ITMD
菱	AFWT
纽	XNFG
瑞	GMDJ
氏	QAV
锁	QIMY
疫	UMCI
桦	SWXF
甸	QLD
岩	MDF
劳	APLB
缓	XEFC
疲	UHCI
谷	WWKF
挫	RWWF
奏	DWGD
延	THPD
篁	TRGF
拟	RNYW
乌	QNGD
扬	RNRT
吸	KEYY
械	SAAH
船	TEMK
粗	OEGG
披	RHCY
露	FKHK
稀	TQDH
扣	RKG
锈	QTEN
扭	RNFG
泾	ICAG
厚	DJBD
阶	BWJH
围	LFNH
碳	DMDO
覆	STTT
盖	UGLF
哀	YEU
堤	FJGH
闭	UFTE
吹	KQWY
浸	IVPC
渤	IFPL
熟	YBVO
遗	KHGP
忘	YNNU
蝶	JANS
泪	IHG
翻	TOLN
牵	DPRH
胞	EQNN
黑	LFOU
慰	NFIN
悲	DJDN
痛	UCEK
凌	UFWT
晨	JDFE
败	MTY
皮	HCI
伦	WWXN
奎	DFFF
贡	AMU
帽	MHJH
托	RTAN
帕	MHRG
努	VCLB
吉	FKF
若	ADKF
挤	RYJH
猛	QTBL
岸	MDFJ
磷	DOQH
酸	SGCT
铵	QPVG
征	TGHG
税	TUKQ
旺	JGG
竹	TTGH
畔	LUFH
钟	QKHH
洞	IMGK
隶	VII
详	YUDH
粒	OUG
溯	IUBE
殆	GQCK
替	FWFJ
守	PFU
鉴	JTYQ
附	BWFY
宜	PEGF
稍	TIEG
辙	LYCT
筑	TAMY
织	XKWY
募	AJDL
施	YTBN
袭	DXYE
裁	FAYE
执	RVYY
励	DDNL
苦	ADF
亡	YNV
庭	YTFP
祈	PYRH
祷	PYDF
履	NTTT
荣	APSU
啤	KRTF
订	YSH
余	WTU
亦	YOU
霞	FNHC
帜	MHKW
陶	BQRM
虚	HAOG
漏	INFY
烈	GQJO
噩	GKKK
殇	GQTR
岷	MNAN
伏	WDY
批	RXXN
抢	RWBN
堰	FAJV
甘	AFD
肃	VIJK
赴	FHHI
芯	ANU
嵌	MAFW
架	LKSU
柜	SANG
监	JTYL
案	PVSU
餐	HQCE
异	NAJ
剖	UKJH
螺	JLXI
旋	YTNH
概	SVCQ
摘	RUMD
简	TUJF
孤	BRCY
牛	RHK
奶	VEN
粉	OWVN
艰	CVEY
弭	XBG
骤	CBCI
茄	ALKF
冕	JQKQ
禽	WYBC
症	UGHD
诊	YWET
吧	KCN
答	TWGK
鸡	CQYG
舍	WFKF
毒	GXGU
贾	SMU
雯	FYU
腹	ETJT
摸	RAJD
肚	EFG
乳	EBNN
沟	IQCY
怀	NGIY
婕	VGVH
梧	SGKG
桐	SMGK
妹	VFIY
钱	QGT
返	RCPI
陪	BUKG
妈	VCG
赞	TFQM
棒	SDWH
辛	UYGH
嫁	VPEY
妇	VVG
奔	DFAJ
帝	UPMH
腊	EAJG
县	EGCU
揪	RTOY
赵	FHQI
帐	MHTY
呼	KTUH
吁	KGFH
渡	IYAC
倾	WXDM
腾	EUDC
庞	YDXV
翼	NLAW
蹈	KHEV
辞	TDUH
拓	RDG
岳	RGMJ
鹰	YWWG
鸣	KQYG
坊	FYN
沽	IDG
飞	NUI
蹄	KHUH
巧	AGNN
喊	KDGT
蛋	NHJU
萤	APJU
尖	IDU
叫	KNHH
掀	RRQW
屋	NGCF
炫	OYXY
暇	JNHC
祥	PYUD
卢	HNE
叡	HPGC
鹏	EEQG
智	TDKJ
泉	RIU
厦	DDHT
玉	GYI
役	TMCY
浔	IVFY
龚	DXAW
松	SWCY
宿	PWDJ
刚	MQJH
巩	AMYY
固	LDD
芳	AYB
媛	VEFC
陕	BGUW
塌	FJNG
惠	GJHN
食	WYVE
篷	TTDP
御	TRHB
寒	PFJU
拨	RNTY
背	UXEF
咖	KLKG
啡	KDJD
睡	HTGF
册	MMGD
珍	GWET
谭	YSJH
泳	IYNI
硅	DFFG
脑	EYBH
暑	JFTJ
诞	YTHP
赖	GKIM
邀	RYTP
魅	RQCI
词	YNGK
恰	NWGK
钻	QHKG
姐	VEGG
妆	UVG
戏	CAT
哈	KWGK
颜	UTEM
恤	NTLG
逸	QKQP
钧	QQUG
阔	UITD
绎	XCFH
篇	TYNA
虹	JAG
萍	AIGH
婷	VYPS
傅	WGEF
仰	WQBH
矍	HHWC
铄	QQIY
辈	DJDL
娟	VKEG
尹	VTE
孟	BLF
芬	AWVB
悟	NGKG
樟	SUJH
穆	TRIE
史	KQI
稿	TYMK
卓	HJJ
妍	VGAH
尊	USGF
斧	WQRJ
盆	WVLF
痕	UVEI
痊	UWGD
愈	WGEN
瞒	HAGW
钦	QQWY
佩	WMGH
捏	RJFG
汗	IFH
艳	DHQC
疼	UTUI
肠	ENRT
挂	RFFG
猫	QTAL
妮	VNXN
姜	UGVF
坞	FQNG
识	YKWY
薄	AIGF
怪	NCFG
兽	ULGK
棚	SEEG
搭	RAWK
寄	PDSK
梦	SSQU
倩	WGEG
梁	IVWS
黯	LFOJ
婚	VQAJ
卦	FFHY
刊	FJH
怒	VCNU
吼	KBNN
脸	EWGI
忙	NYNN
奈	DFIU
父	WQU
梅	STXU
九	VTN
塘	FYVK
寓	PJMY
瘦	UVHC
肤	EFWY
蓬	ATDP
框	SAGG
镜	QUJQ
厢	DSHD
警	AQKY
戒	AAK
狗	QTQK
仔	WBG
啦	KRUG
怜	NWYC
旭	VJD
塑	UBTF
函	BIBK
寿	DTFU
姑	VDG
叩	KBH
祭	WFIU
跪	KHQB
诚	YDNT
陵	BFWT
葬	AGQA
啷	KYVB
锌	QUH
冶	UCKG
炼	OANW
躲	TMDS
懋	SCBN
铅	QMKG
岭	MWYC
蜀	LQJU
霁	FYJJ
屏	NUAK
碎	DYWF
毂	FPLC
撞	RUJF
陷	BQVG
彻	TAVN
夹	GUWI
钳	QAFG
俗	WWWK
涂	IWTY
漆	ISWI
磨	YSSD
酿	SGYE
昊	JGDU
乓	RGYU
敲	YMKC
抽	RMG
朱	RII
爀	OFOO
垠	FVEY
瓷	UQWN
琳	GSSY
勤	AKGL
皓	RTFK
楠	SFMF
抓	RRHY
鞍	AFPV
凭	WTFM
借	WAJG
揽	RJTQ
杠	SAG
岑	MWYN
吊	KMHJ
郝	FOBH
浦	IGEY
潮	IFJE
茅	ACBT
澜	IUGI
瞩	HNTY
踵	KHTF
屡	NOVD
忡	NKHH
液	IYWY
床	YSI
诗	YFFY
尝	IPFC
姻	VLDY
谐	YXXR
课	YJSY
臣	AHNH
婆	IHCV
穷	PWLB
鬼	RQCI
冇	DMB
瘪	UTHX
蛮	YOJU
攒	RTFM
私	TCY
睁	HQVH
喝	KJQN
抖	RUFH
躺	TMDK
唦	KIIT
咧	KGQJ
凑	UDWD
偷	WWGJ
晃	JIQB
瞄	HALG
摞	RLXI
呵	KSKG
煮	FTJO
饭	QNRC
怕	NRG
灰	DOU
韬	FNHV
措	RAJG
硬	DGJQ
琼	GYIY
乃	ETN
谊	YPEG
斗	UFK
惨	NCDE
眶	HAGG
玛	GCG
弗	XJK
泽	ICFH
俐	WTJH
鼓	FKUC
幽	XXMK
颠	FHWM
挠	RATQ
镇	QFHW
暗	JUJG
勾	QCI
妄	YNVF
寇	PFQC
嚣	KKDK
摧	RMWY
毁	VAMC
炭	MDOU
抹	RGSY
菌	ALTU
灭	GOI
怖	NDMH
谋	YAFS
挖	RPWN
隐	BQVN
党	IPKQ
沈	IPQN
帷	MHWY
氛	RNWV
伶	WWYC
芝	APU
冬	TUU
蒲	AIGY
莺	APQG
璇	GYTH
羲	UGTT
袂	PUNW
漫	IJLC
踞	KHND
婉	VPQB
柔	CBTS
湛	IADN
奋	DLF
丝	XXGF
泛	ITPY
荧	APOU
侣	WKKG
竟	UJQB
惟	NWYG
妙	VITT
叹	KCY
愧	NRQC
裔	YEMK
衔	TQFH
浑	IPLH
赋	MGAH
汕	IMH
址	FHG
滨	IPRW
赢	YNKY
鸟	QYNG
忌	NNU
樊	SQQD
扳	RRCY
氯	RNVI
碱	DDGT
兵	RGWU
氨	RNPV
横	SAMW
扫	RVG
洗	ITFQ
霜	FSHF
晒	JSG
湿	IJOG
唇	DFEK
膏	YPKE
沐	ISY
浴	IWWK
玫	GTY
堂	IPKF
捉	RKHY
逞	KGPD
煤	OAFS
捷	RGVH
畊	LFJH
苑	AQBB
搏	RGEF
挣	RQVH
龄	HWBC
榴	SQYL
颤	YLKM
巍	MTVC
狼	QTYE
蓓	AWUK
堪	FADN
鼎	HNDN
途	WTPI
掏	RQRM
腰	ESVG
野	JFCB
镑	QUPY
逾	WGEP
迌	EPD
纭	XFCY
蚀	QNJY
赚	MUVO
徘	TDJD
徊	TLKG
凸	HGMG
犯	QTBN
舆	WFLW
漩	IYTH
某	AFSU
绯	XDJD
纬	XFNH
袖	PUMG
衬	PUFY
衫	PUET
嫌	VUVO
吗	KCG
胆	EJGG
衰	YKGE
退	VEPI
符	TWFU
伐	WAT
趣	FHBC
衍	TIFH
赌	MFTJ
涤	ITSY
督	HICH
皂	RAB
胁	ELWY
鹿	YNJX
锻	QWDC
洙	IRIY
冯	UCG
蔚	ANFF
彦	UTER
峻	MCWT
慷	NYVI
慨	NVCQ
伸	WJHH
死	GQXB
霄	FIEF
插	RTFV
葭	ANHC
瑛	GAMD
滤	IHAN
残	GQGT
培	FUKG
疾	UTDI
夕	QTNY
拘	RQKG
渴	IJQN
绚	XQJG
烂	OUFG
姿	UQWV
敦	YBTY
纲	XMQY
扈	YNKC
娘	VYVE
矮	TDTV
虎	HAMV
扮	RWVN
浒	IYTF
聪	BUKN
贷	WAMU
赔	MUKG
律	TVFH
锣	QLQY
铺	QGEY
碟	DANS
隧	BUEP
毫	YPTN
血	TLD
踊	KHCE
瓜	RCYI
杉	SET
矶	DMN
皇	RGF
闲	USI
窄	PWTF
旦	JGF
玲	GWYC
零	FWYC
陇	BDXN
轧	LNN
河	ISKG
闽	UJI
琛	GPWS
甜	TDAF
驻	CYGG
阎	UQVD
沧	IWBN
雨	FGHY
揣	RMDJ
趁	FHWE
洽	IWGK
坡	FHCY
锡	QJQR
摆	RLFC
欲	WWKW
楼	SOVG
弃	YCAJ
硕	DDMY
亨	YBJ
炒	OITT
憧	NUJF
憬	NJYI
於	YWUY
剥	VIJH
拆	RRYY
靖	UGEG
棉	SRMH
纺	XYN
顷	XDMY
污	IFNN
染	IVSU
庙	YMD
霆	FTFP
闪	UWI
耀	IQNY
邦	DTBH
耶	BBH
须	EDMY
触	QEJY
慕	AJDN
魏	TVRC
欣	RQWY
押	RLH
尴	DNJL
尬	DNWJ
旬	QJD
爵	ELVF
崇	MPFI
寥	PNWE
肩	YNED
雏	QVWY
渐	ILRH
勃	FPBL
蛰	RVYJ
浮	IEBG
焰	OQVG
朵	MSU
彭	FKUE
帅	JMHH
晏	JPVF
憾	NDGN
刷	NMHJ
扩	RYT
厉	DDNV
彤	MYET
挽	RQKQ
捣	RQYM
窝	PWKW
耕	DIFJ
坑	FYMN
罪	LDJD
秩	TRWY
斥	RYI
嘴	KHXE
草	AJJ
蚕	GDJU
谜	YOPY
牺	TRSG
牲	TRTG
冤	PQKY
囚	LWI
宅	PTAB
拒	RANG
蝴	JDEG
谁	YWYG
汀	ISH
霍	FWYF
玮	GFNH
室	PGCF
沿	IMKG
亩	YLF
渔	IQGG
遵	USGP
粮	OYVE
肇	YNTH
冈	MQI
绥	XEVG
蛇	JPXN
泗	ILG
泥	INXN
逢	TDHP
倡	WJJG
氧	RNUD
寡	PDEV
佛	WXJH
掘	RNBM
抬	RCKG
肢	EFCY
愉	NWGJ
衅	TLUF
挨	RCTD
歉	UVOW
挚	RVYR
饱	QNQN
踩	KHES
踏	KHIJ
惹	ADKN
麻	YSSI
烦	ODMY
晴	JGEG
芜	AFQB
妻	GVHV
禹	TKMY
玩	GFQN
嘛	KYSS
衷	YKHE
馨	FNMJ
缔	XUPH
璐	GKHK
膨	EFKE
枯	SDG
琰	GOOY
卵	QYTY
巢	VJSU
祸	PYKW
妊	VTFG
娠	VDFE
哺	KGEY
癌	UKKM
酮	SGMK
巅	MFHM
泌	INTT
痹	ULGJ
肽	EDYY
淤	IYWU
髓	MEDP
椎	SWYG
患	KKHN
凉	UYIY
脊	IWEF
柱	SYGG
炎	OOU
矛	CBTR
慢	NJLC
割	PDHJ
歧	HFCY
裙	PUVK
旁	UPYB
胸	EQQB
惜	NAJG
黔	LFON
驴	CYNT
姚	VIQN
碰	DUOG
琦	GDSK
镛	QYVH
珊	GMMG
伉	WYMN
俪	WGMY
宛	PQBB
殷	RVNC
剪	UEJV
桂	SFFG
纶	XWXN
镁	QUGD
箍	TRAH
暴	JAWI
臂	NKUE
裤	PUYL
砰	DGUH
晖	JPLH
锤	QTGF
穴	PWU
乙	NNLL
踢	KHJR
糕	OUGO
舟	TEI
彰	UJET
邮	MBH
夷	GXWI
叠	CCCG
忍	VYNU
哭	KKDU
炸	OTHF
坝	FMY
拯	RBIG
摊	RCWY
疯	UMQI
绑	XDTB
腕	EPQB
捆	RLSY
踉	KHYE
跄	KHWB
摔	RYXF
龈	HWBE
磕	DFCL
鲜	QGUD
缝	XTDP
碍	DJGF
疤	UCV
尘	IFF
雄	DCWY
鞋	AFFF
昔	AJF
拦	RUFG
哽	KGJQ
咽	KLDY
脏	EYFG
宕	PDF
魂	FCRC
搬	RTEC
喂	KLGE
恳	VENU
贮	MPGG
绒	XADT
夸	DFNB
灿	OMH
隙	BIJI
劝	CLN
填	FFHW
胳	ETKG
膊	EGEF
逛	QTGP
茫	AIYN
烯	OQDH
炉	OYNT
邱	RGBH
壑	HPGF
扰	RDNN
猜	QTGE
襟	PUSI
肘	EFY
鄂	KKFB
振	RDFE
缴	XRYT
舶	TERG
汪	IGG
废	YNTY
墟	FHAG
悼	NHJH
滴	IUMD
肮	EYMN
诠	YWGG
斩	LRH
膛	EIPF
淌	IIMK
诟	YRGK
遣	KHGP
犹	QTDN
豫	CBQE
莎	AIIT
檬	SAPE
井	FJK
幂	PJDH
闹	UYMH
匆	QRYI
既	VCAQ
碌	DVIY
泻	IPGG
漂	ISFI
磅	DUPY
孳	UXXB
遏	JQWP
盎	MDLF
蔓	AJLC
旨	XJF
辟	NKUH
谣	YERM
邻	WYCB
绞	XUQY
汁	IFH
肝	EFH
锐	QUKQ
坎	FQWY
墙	FFUK
壁	NKUF
棕	SPFI
榈	SUKK
狂	QTGG
郁	DEBH
莽	ADAJ
潘	ITOL
叛	UDRC
枪	SWBN
叔	HICY
瞻	HQDY
掩	RDJN
迁	TFPK
颗	JSDM
峡	MGUW
飘	SFIQ
畴	LDTF
粹	OYWF
姬	VAHH
革	AFJ
绽	XPGH
愁	TONU
鳗	QGJC
觥	QEIQ
恨	NVEY
铩	QQSY
赏	IPKM
诵	YCEH
倪	WVQN
埋	FJFG
翁	WCNF
皆	XXRF
铂	QRG
钯	QCN
搂	ROVG
暧	JEPC
昧	JFIY
哼	KYBH
讽	YMQY
媳	VTHN
掳	RHAL
裸	PUJS
杜	SFG
琉	GYCQ
覃	SJJ
羿	NAJ
麟	YNJH
佣	WEH
桩	SYFG
贿	MDEG
窃	PWAV
诈	YTHF
骗	CYNA
脉	EYNI
帑	VCMH
恕	VKNU
丑	NFD
诱	YTEN
挪	RVFB
鹤	PWYG
娄	OVF
宪	PTFQ
瑜	GWGJ
珈	GLKG
惫	TLNU
吃	KTNN
丈	DYI
哗	KWXF
啕	KQRM
遥	ERMP
缉	XKBG
笛	TMF
郅	GCFB
炜	OFNH
蜡	JAJG
烛	OJY
曳	JXE
辱	DFEF
骂	KKCF
歇	JQWW
罹	LNWY
泣	IUG
嵩	MYMK
晶	JJJF
刑	GAJH
圃	LGEY
悚	NGKI
湄	INHG
劈	NKUV
葡	AQGY
萄	AQRM
租	TEGG
灏	IJYM
渊	ITOH
殊	GQRI
链	QLPY
磋	DUDA
泄	IANN
朴	SHY
焕	OQMD
鲍	QGQN
顽	FQDM
犀	NIRH
刀	VNT
齿	HWBJ
藉	ADIJ
溪	IEXD
斜	WTUF
稠	TMFK
淀	IPGH
趸	DNKH
丢	TFCU
讼	YWCY
逮	VIPI
捕	RGEY
侦	WHMY
欠	QWU
笼	TDXB
喻	KWGJ
坠	BWFF
轨	LVN
尧	ATGQ
灶	OFG
爷	WQBJ
轰	LCCU
滥	IJTL
醉	SGYF
滋	IUXX
纠	XNHH
缠	XYJF
砸	DAMH
酣	SGAF
丙	GMWI
酰	SGTQ
胺	EPVG
羊	UDJ
埔	FGEY
苹	AGUH
瞧	HWYO
傻	WTLT
珀	GRG
卑	RTFJ
瑟	GGNT
诡	YQDB
闺	UFFD
怨	QBNU
仁	WFG
芙	AFWU
凶	QBK
郡	VTKB
躁	KHKS
乔	TDJJ
旱	JFJ
佐	WDAG
愤	NFAM
厄	DBV
弦	XYXY
宴	PJVF
孝	FTBF
蕴	AXJL
绘	XWFC
浅	IGT
乍	THFD
悠	WHTN
涵	IBIB
惺	NJTG
嘘	KHAG
惋	NPQB
懂	NATF
拷	RFTN
唤	KQMD
涩	IVYH
陌	BDJG
觊	MNMQ
觎	WGEQ
垒	CCCF
叼	KNGG
潇	IAVJ
洒	ISG
佬	WFTX
惑	AKGN
慌	NAYQ
削	IEJH
咒	KKMB
酬	SGYH
昭	JVKG
宫	PKKF
晦	JTXU
妨	VYN
忆	NNN
萧	AVIJ
迥	MKPD
咎	THKF
拳	UDRJ
绅	XJHH
疆	XFGG
噢	KTMD
迄	TNPV
珏	GGYY
罩	LHJJ
辩	UYUH
喘	KMDJ
惕	NJQR
忻	NRH
酌	SGQY
谴	YKHP
滩	ICWY
糟	OGMJ
寅	PGMW
卯	QTBH
彼	THCY
涌	ICEH
稚	TWYG
嫩	VGKT
粘	OHKG
蹂	KHCS
躏	KHAY
胖	EUFH
兜	QRNQ
饿	QNTT
邪	AHTB
滕	EUDI
旷	JYT
茂	ADNT
脖	EFPB
饥	QNMN
桨	UQSU
抚	RFQN
疮	UWBV
痍	UGXW
咔	KHHY
嚓	KPWI
倦	WUDB
洪	IAWY
诫	YAAH
佑	WDKG
孚	EBF
酷	SGTK
豹	EEQY
驭	CCY
庸	YVEH
卤	HLQI
氙	RNMJ
撤	RYCT
喇	KGKJ
臀	NAWE
暮	AJDJ
谚	YUTE
魁	RQCF
肌	EMN
兹	UXXU
咬	KUQY
膝	ESWI
丧	FUEU
嚷	KYKE
逝	RRPK
紊	YXIU
淳	IYBG
勘	ADWL
竭	UJQN
荆	AGAJ
阁	UTKD
昙	JFCU
匮	AKHM
兔	QKQY
抄	RITT
拜	RDFH
茵	ALDU
媺	VMGT
啖	KOOY
歪	GIGH
魄	RRQC
跋	KHDC
粤	TLON
珉	GNAN
佟	WTUY
吞	GDKF
弧	XRCY
掷	RUDB
趟	FHIK
汹	IQBH
惦	NYHK
腐	YWFW
渣	ISJG
搅	RIPQ
犬	DGTY
裘	FIYE
穗	TGJN
淋	ISSY
漓	IYBC
刃	VYI
擦	RPWI
炮	OQNN
嘟	KFTB
眷	UDHF
邵	VKBH
吻	KQRT
佼	WUQY
隋	BDAE
钊	QJH
扑	RHY
驰	CBN
斐	DJDY
袋	WAYE
浏	IYJH
梯	SUXT
泡	IQNN
爬	RHYC
崩	MEEF
溃	IKHM
斑	GYGG
斓	YUGI
挡	RIVG
巾	MHK
骏	CCWT
舰	TEMQ
诩	YNG
抨	RGUH
疏	NHYQ
树	SCFY
沦	IWXN
闯	UCD
咄	KBMH
弄	GAJ
骚	CCYJ
雇	YNWY
翔	UDNG
袍	PUQN
窥	PWFQ
貌	EERQ
卷	UDBB
浓	IPEY
梳	SYCQ
腔	EPWA
睹	HFTJ
裕	PUWK
郊	UQBH
碑	DRTF
缅	XDMD
潋	IWGT
驳	CQQY
柄	SGMW
乖	TFUX
剔	JQRJ
瑕	GNHC
疵	UHXV
毋	XDE
踪	KHPI
泼	INTY
硫	DYCQ
奕	YODU
睐	HGOY
瑰	GRQC
牡	TRFG
拌	RUFH
酱	UQSG
厨	DGKF
鳝	QGUK
糊	ODEG
烹	YBOU
馅	QNQV
饺	QNUQ
桌	HJSU
筷	TNNW
晕	JPLJ
辣	UGKI
饯	QNGT
椒	SHIC
炖	OGBN
巷	AWNB
邹	QVBH
匿	AADK
矩	TDAN
栅	SMMG
菁	AGEF
坍	FMYG
荒	AYNQ
砾	DQIY
堆	FWYG
梭	SCWT
寂	PHIC
垣	FGJG
筋	TELB
炊	OQWY
锅	QKMW
盐	FHLF
闷	UNI
唾	KTGF
妃	VNN
耸	WWBF
俩	WGMW
刹	QSJH
盒	WGKL
羞	UDNF
耻	BHG
眠	HNAN
茨	AUQW
堡	WKSF
鸠	VQYG
敛	WGIT
腼	EDMD
腆	EMAW
屁	NXXV
侨	WTDJ
谦	YUVO
憨	NBTN
烟	OLDY
欺	ADWW
鹫	YIDG
犷	QTYT
莹	APGY
饶	QNAQ
岚	MMQU
猎	QTAJ
锵	QUQF
仗	WDYY
焱	OOOU
猴	QTWD
鳞	QGOH
樱	SMMV
葩	ARCB
轶	LRWY
爽	DQQQ
濠	IYPE
阪	BRCY
扁	YNMA
煞	QVTO
袄	PUTD
咋	KTHF
舌	TDD
喀	KPTK
甫	GEHY
娣	VUXT
拾	RWGK
赁	WTFM
浐	IUTT
纵	XWWY
帆	MHMY
刮	TDJH
筐	TAGF
凳	WGKM
绊	XUFH
崖	MDFF
捅	RCEH
侃	WKQN
吓	KGHY
牧	TRTY
遮	YAOP
耍	DMJV
哇	KFFG
哦	KTRT
循	TRFH
礁	DWYO
匕	XTN
戈	AGNT
墅	JFCF
飒	UMQY
涅	IJFG
侮	WTXU
澎	IFKE
悦	NUKQ
瞿	HHWY
婧	VGEG
韶	UJVK
徳	TFLN
祯	PYHM
吝	YKF
啬	FULK
谩	YJLC
卿	QTVB
舵	TEPX
懈	NQEH
倚	WDSK
钩	QQCY
铃	QWYC
牢	PRHJ
圭	FFF
踹	KHMJ
鏖	YNJQ
脆	EQDB
铲	QUTT
嗅	KTHD
媲	VTLX
窍	PWAN
屠	NFTJ
弯	YOXB
簇	TYTD
骁	CATQ
沸	IXJH
宙	PMF
澄	IWGU
锯	QNDG
僵	WGLG
盲	YNHF
囤	LGBN
亢	YMB
雕	MFKY
薇	ATMT
酝	SGFC
捍	RJFH
譬	NKUY
烫	INRO
芋	AGFJ
饽	QNFB
膜	EAJD
釉	TOMG
槽	SGMJ
匀	QUD
橘	SCBK
橙	SWGU
麒	YNJW
践	KHGT
仲	WKHH
侵	WVPC
擅	RYLG
檀	SYLG
臆	EUJN
淆	IQDE
枢	SAQY
壤	FYKE
弊	UMIA
岂	MNB
绸	XMFK
町	LSH
钉	QSH
酋	USGF
颓	TMDM
啸	KVIJ
匠	ARK
妖	VTDY
迭	RWPI
吟	KWYN
聆	BWYC
磁	DUXX
呀	KAHT
咚	KTUY
嘶	KADR
墈	FADL
霾	FEEF
苍	AWBB
葵	AWGD
呐	KMWY
婴	MMVF
煌	ORGG
祁	PYBH
拗	RXLN
堕	BDEF
晗	JWYK
缕	XOVG
幢	MHUF
鄢	GHGB
钛	QDYY
钒	QMYY
藤	AEUI
屈	NBMK
辜	DUJ
沫	IGSY
妥	EVF
拐	RKLN
汐	IQY
斟	ADWF
蹿	KHPH
弈	YOAJ
夭	TDI
飚	MQOO
挟	RGUW
嫉	VUTD
妒	VYNT
镕	QPWK
烙	OTKG
丛	WWGF
殖	GQFH
绳	XKJN
讶	YAHT
甩	ENV
糙	OTFP
颈	CADM
咱	KTHG
扯	RHG
诽	YDJD
谤	YUPY
唆	KCWT
淫	IETF
秽	TMQY
删	MMGJ
辖	LPDK
逻	LQPI
滞	IGKH
讳	YFNH
胃	LEF
襄	YKKE
瀛	IYNY
潭	ISJH
荔	ALLL
砻	DXDF
纤	XTFH
楷	SXXR
痴	UTDK
沛	IGMH
侠	WGUW
翡	DJDN
澍	IFKF
舜	EPQH
珺	GVTK
琪	GADW
韵	UJQU
蔺	AUWY
萌	AJEF
沁	INY
茜	ASF
蓉	APWK
剿	VJSJ
睿	HPGH
秉	TGVI
遂	UEPI
晤	JGKG
庐	YYNE
邃	PWUP
缥	XSFI
缈	XHIT
辰	DFEI
塬	FDRI
陀	BPXN
朦	EAPE
胧	EDXN
濒	IHIM
萎	ATVF
戚	DHIT
拱	RAWY
竣	UCWT
阚	UNBT
垃	FUG
圾	FEYY
抠	RAQY
鼻	THLJ
赤	FOU
吾	GKF
斋	YDMJ
麓	SSYX
邡	YBH
钙	QGHN
钾	QLH
锭	QPGH
氢	RNCA
筠	TFQU
叙	WTCY
摹	AJDR
芒	AYNB
艇	TETP
蕙	AGJN
彪	HAME
骋	CMGN
摒	RNUA
睦	HFWF
栩	SNG
淅	ISRH
昇	JTAJ
宰	PUJ
炯	OMKG
溱	IDWT
柁	SPXN
熹	FKUO
瀚	IFJN
坯	FGIG
艘	TEVC
仇	WVN
凄	UGVV
罕	PWFJ
遐	NHFP
缤	XPRW
鹦	MMVG
鹉	GAHG
骷	MEDG
髅	MEOV
镍	QTHS
雾	FTLB
砌	DAVN
憷	NSSH
惧	NHWY
嗓	KCCS
萱	APGG
谱	YUOJ
垫	RVYF
腋	EYWY
宵	PIEF
厌	DDI
嗜	KFTJ
煎	UEJO
熬	GQTO
焚	SSOU
悔	NTXU
筛	TJGH
槛	SJTL
棍	SJXX
昶	YNIJ
遑	RGPD
攥	RTHI
溏	IYVK
奸	VFH
菊	AQOU
狸	QTJF
吵	KITT
扇	YNND
贪	WYNM
瘾	UBQN
掴	RLGY
嬅	VAGF
荃	AWGF
淑	IHIC
逗	GKUP
婶	VPJH
咳	KYNW
肺	EGMH
銮	YOQF
盯	HSH
熏	TGLO
耽	BPQN
啼	KUPH
狭	QTGW
厮	DADR
乾	FJTN
郦	GMYB
拮	RFKG
媚	VNHG
狮	QTJH
哨	KIEG
殿	NAWC
猝	QTYF
砖	DFNY
芭	ACB
镶	QYKE
珲	GPLH
抒	RCBH
浊	IJY
榻	SJNG
坪	FGUH
苔	ACKF
钥	QEG
匙	JGHX
茶	AWSU
腑	EYWF
催	WMWY
恼	NYBH
瞅	HTOY
蝉	JUJF
苞	AQNB
砍	DQWY
鲨	IITG
觅	EMQB
噪	KKKS
烷	OPFQ
冼	UTFQ
礴	DAIF
羁	LAFC
矫	TDTJ
贱	MGT
禺	JMHY
尸	NNGT
笃	TCF
冥	PJUU
棘	GMII
誓	RRYF
饲	QNNK
曦	JUGT
隽	WYEB
棣	SVIY
廊	YYVB
哄	KAWY
拙	RBMH
羡	UGUW
珂	GSKG
栽	FASI
畏	LGEU
浇	IATQ
丸	VYI
姊	VTNT
拇	RXGU
撰	RNNW
鳕	QGFV
垂	TGAF
蔻	APFC
炙	QOU
珑	GDXN
徒	TFHY
僧	WULJ
瘫	UCWY
痪	UQMD
霖	FSSU
奢	DFTJ
侈	WQQY
傍	WUPY
膺	YWWE
岗	MMQU
嫂	VVHC
宠	PDXB
诀	YNWY
瞪	HWGU
柬	GLII
寨	PFJS
玖	GQYY
渎	IFND
溜	IQYL
愚	JMHN
蠢	DWJJ
鹂	GMYG
醇	SGYB
蜥	JSRH
蜴	JJQR
瘟	UJLD
屯	GBNV
榆	SWGJ
贇	YGAM
祺	PYAW
琨	GJXX
仕	WFG
阮	BFQN
镯	QLQJ
颐	AHKM
卧	AHNH
稻	TEVG
唏	KQDH
憋	UMIN
孢	BQNN
钠	QMWY
甬	CEJ
熄	OTHN
盏	GLF
跻	KHYJ
龛	WGKX
畜	YXLF
柠	SPSH
侍	WFFY
桀	QAHS
骜	GQTC
驯	CKH
麾	YSSN
茬	ADHF
萦	APXI
翅	FCND
拭	RAAG
徕	TGOY
麽	YSSC
苛	ASKF
陋	BGMN
唉	KCTD
澈	IYCT
喧	KPGG
丫	UHK
歹	GQI
髦	DETN
卉	FAJ
伺	WNGK
掐	RQVG
垮	FDFN
韧	FNHY
篑	TKHM
妓	VFCY
蛤	JWGK
蟆	JAJD
爹	WQQQ
绰	XHJH
骛	CBTC
矗	FHFH
邋	VLQP
遢	JNPD
殴	AQMC
哉	FAKD
忝	GDNU
巫	AWWI
橱	SDGF
筝	TQVH
钨	QQNG
冀	UXLW
慑	NBCC
扛	RAG
扼	RDBN
靥	DDDD
噱	KHAE
玟	GYY
株	SRIY
堵	FFTJ
辄	LBNN
淇	IADW
佘	WFIU
昵	JNXN
凿	OGUB
赊	MWFI
恭	AWNU
阐	UUJF
缨	XMMV
汝	IVG
寺	FFU
邛	ABH
崃	MGOY
蚂	JCG
蚁	JYQY
驿	CCFH
橄	SNBT
榄	SJTQ
叉	CYI
戟	FJAT
辐	LGKL
娴	VUSY
懒	NGKM
淮	IWYG
沾	IHKG
榨	SPWF
麂	YNJM
芽	AAHT
蚤	CYJU
鹅	TRNG
殃	GQMD
渗	ICDE
翘	ATGN
蕾	AFLF
臭	THDU
骐	CADW
俨	WGOD
楔	SDHD
朔	UBTE
弩	VCXB
梓	SUH
秸	TFKG
秆	TFH
哑	KGOG
铆	QQTB
屹	MTNN
俭	WWGI
谙	YUJG
叮	KSH
嘱	KNTY
苟	AQKF
腺	ERIY
肿	EKHH
癣	UQGD
屑	NIED
朊	EFQN
莘	AUJ
膀	EUPY
砝	DFCY
缇	XJGH
帘	PWMH
弘	XCY
蜗	JKMW
聋	DXBF
啶	KPGH
哌	KREY
呋	KFWY
噻	KPFF
肟	EFNN
吩	KWVN
喆	FKFK
癫	UFHM
虫	JHNY
摈	RPRW
卒	YWWF
碁	ADWD
峥	MQVH
簸	TADC
憎	NULJ
盼	HWVN
梗	SGJQ
窿	PWBG
谑	YHAG
蔽	AUMT
谎	YAYQ
锗	QFTJ
矢	TDU
嘲	KFJE
趴	KHWY
眸	HCRH
羔	UGOU
蹲	KHUF
兢	DQDQ
汲	IEYY
曙	JLFJ
扒	RWY
撇	RUMT
沮	IEGG
屉	NANV
砥	DQAY
忱	NPQN
熠	ONRG
腥	EJTG
筱	TWHT
墓	AJDF
潦	IDUI
掬	RQOY
褪	PUVP
泵	DIU
蔷	AFUK
啥	KWFK
撂	RLTK
隅	BJMY
枝	SFCY
淼	IIIU
驹	CQKG
雍	YXTY
倘	WIMK
撮	RJBC
涎	ITHP
掣	RMHR
恬	NTDG
鼠	VNUN
荻	AQTO
泊	IRG
稽	TDNJ
婪	SSVF
捂	RGKG
崭	MLRJ
迸	UAPK
琢	GEYY
陡	BFHY
禧	PYFK
叭	KWY
潢	IAMW
纹	XYY
绮	XDSK
睇	HUXT
邂	QEVP
逅	RGKP
夯	DLB
袒	PUJG
桎	SGCF
梏	STFK
虏	HALV
冢	PEYU
丘	RGD
皙	SRRF
哩	KJFG
亘	GJGF
袈	LKYE
裟	IITE
喽	KOVG
厕	DMJK
菩	AUKF
灼	OQYY
戳	NWYA
奚	EXDU
圩	FGFH
缆	XJTQ
虢	EFHM
卸	RHBH
俑	WCEH
妞	VNFG
嗯	KLDN
梨	TJSU
渺	IHIT
颅	HNDM
疽	UEGD
肾	JCEF
昼	NYJG
遛	QYVP
漱	IGKW
锨	QRQW
荫	ABEF
赳	FHNH
褒	YWKE
楣	SNHG
殡	GQPW
掖	RYWY
囡	LVD
贼	MADT
赃	MYFG
痒	UUDK
耿	BOY
闸	ULK
筒	TMGK
奴	VCY
跷	KHAQ
螃	JUPY
蟹	QEVJ
惶	NRGG
诧	YPTA
觑	HAOQ
皖	RPFQ
愎	NTJT
烽	OTDH
竿	TFJ
臻	GCFT
匪	ADJD
儒	WFDJ
溺	IXUU
塾	YBVF
靡	YSSD
辫	UXUH
萝	ALQU
卜	HHY
扉	YNDD
偈	WJQN
孑	BNHG
哧	KFOY
禀	YLKI
啜	KCCC
蕉	AWYO
屎	NOI
寰	PLGE
亭	YPSJ
窦	PWFD
虐	HAAG
钗	QCYY
寝	PUVC
扔	REN
嬉	VFKK
僻	WNKU
芹	ARJ
箫	TVIJ
肋	ELN
壶	FPOG
镂	QOVG
幔	MHJC
癖	UNKU
嗽	KGKW
厥	DUBW
喃	KFMF
恍	NIQN
惚	NQRN
潸	ISSE
躯	TMDQ
淹	IDJN
盔	DOLF
璧	NKUY
贩	MRCY
亳	YPTA
邢	GABH
烘	OAWY
豁	PDHK
捡	RWGI
虞	HAKD
铣	QTFQ
寞	PAJD
蒸	ABIO
妩	VFQN
蔗	AYAO
鲅	QGDC
砂	DITT
噬	KTAW
埗	FHIT
悯	NUYY
惰	NDAE
嘿	KLFO
厘	DJFD
棱	SFWT
睫	HGVH
饕	KGNE
餮	GQWE
搪	RYVK
滢	IAPY
濛	IAPE
赣	UJTM
剽	SFIJ
俯	WYWF
瞰	HNBT
彧	AKGE
炽	OKWY
娅	VGOG
罄	FNMM
瓯	AQGN
胤	TXEN
绣	XTEN
咪	KOY
栗	SSU
惭	NLRH
洼	IFFG
壹	FPGU
佰	WDJG
擂	RFLG
曰	JHNG
偕	WXXR
肆	DVFH
挝	RFPY
锰	QBLG
钴	QDG
锆	QTFK
岌	MEYU
秤	TGUH
醛	SGAG
渍	IGMY
莆	AGEY
垦	VEFF
涝	IAPL
脾	ERTF
槐	SRQC
痉	UCAD
挛	YORJ
枰	SGUH
撕	RADR
耘	DIFC
沼	IVKG
狱	QTYD
荏	AWTF
苒	AMFF
枞	SWWY
俎	WWEG
翟	NWYF
泺	IQIY
嗑	KFCL
榭	STMF
讷	YMWY
馏	QNQL
馁	QNEV
磐	TEMD
蜘	JTDK
蛛	JRIY
钵	QSGG
棵	SJSY
咸	DGKT
镳	QYNO
膘	ESFI
雀	IWYF
酯	SGXJ
弓	XNGN
匝	AMHK
槌	SWNP
沂	IRH
鳄	QGKN
粥	XOXN
袱	PUWD
尿	NII
浆	UQIU
诛	YRIY
郜	TFKB
澡	IKKS
稣	QGTY
轫	LVYY
焊	OJFH
簿	TIGF
栎	SQIY
铮	QQVH
堃	YYFF
煜	OJUG
洵	IQJG
烤	OFTN
怠	CKNU
莞	APFQ
抉	RNWY
牍	THGD
袜	PUGS
盗	UQWL
讪	YMH
捞	RAPL
鲶	QGWN
鳌	GQTG
缙	XGOJ
钰	QGYY
垚	FFFF
蹊	KHED
畸	LDSK
赂	MTKG
愕	NKKN
愣	NLYN
贞	HMU
偃	WAJV
渭	ILEG
揉	RCBS
鬓	DEPW
硝	DIEG
狩	QTPF
悖	NFPB
褐	PUJN
瘸	ULKW
椰	SBBH
泯	INAN
鹊	AJQG
诣	YXJG
蝙	JYNA
蝠	JGKL
啻	UPMK
嚼	KELF
洱	IBG
鸭	LQYG
嚎	KYPE
哎	KAQY
苯	ASGF
疖	UBK
疡	UNRE
仑	WXB
藻	AIKS
絮	VKXI
蛟	JUQY
陨	BKMY
牟	CRHJ
泸	IHNT
枣	GMIU
讫	YTNN
驼	CPXN
驸	CWFY
桉	SPVG
栓	SWGG
钼	QHG
锴	QXXR
铸	QDTF
皱	QVHC
颊	GUWM
铿	QJCF
馥	TJTT
歆	UJQW
邑	KCB
璟	GJYI
墀	FNIH
梢	SIEG
枫	SMQY
窜	PWKH
窖	PWTK
蹶	KHDW
梠	SKKG
笠	TUF
崎	MDSK
衢	THHH
钞	QITT
恙	UGNU
穹	PWXB
玺	QIGY
漯	ILXI
蒿	AYMK
闵	UYI
竺	TFF
踝	KHJS
皎	RUQY
呜	KQNG
祉	PYHG
蜃	DFEJ
莅	AWUF
狄	QTOY
汾	IWVN
睽	HWGD
彷	TYN
徨	TRGG
胫	ECAG
玥	GEG
悸	NTBG
眨	HTPY
挎	RDFN
笨	TSGF
匈	QQBK
掂	RYHK
蛀	JYGG
凹	MMGD
骇	CYNW
撬	RTFN
裨	PURF
栖	SSG
镀	QYAC
铬	QTKG
孰	YBVY
搁	RUTK
捺	RDFI
龇	HWBX
偊	WTKY
纰	XXXN
弋	AGNY
晔	JWXF
杳	SJF
赅	MYNW
宸	PDFE
琥	GHAM
姣	VUQY
仆	WHY
脐	EYJH
瘤	UQYL
芮	AMWU
釜	WQFU
虔	HAYI
膳	EUDK
碗	DPQB
辗	LNAE
黒	JFOU
掺	RCDE
峙	MFFY
婀	VBSK
伞	WUHJ
眺	HIQN
拎	RWYC
阀	UWAE
恺	NMNN
汞	AIU
锂	QJFG
薰	ATGO
铉	QYXY
狈	QTMY
猩	QTJG
廿	AGHG
嘻	KFKK
懊	NTMD
殒	GQKM
茏	ADXB
潍	IXWY
溴	ITHD
谛	YUPH
踌	KHDF
躇	KHAJ
鸦	AHTG
诋	YQAY
靴	AFWX
勿	QRE
捶	RTGF
卞	YHU
杖	SDYY
枉	SGG
蚊	JYY
翩	YNMN
偎	WLGE
莓	ATXU
蹦	KHME
伎	WFCY
缀	XCCC
娶	BCVF
炕	OYMN
姥	VFTX
馒	QNJC
眯	HOY
腩	EFMF
舅	VLLB
姨	VGXW
燊	OOOS
躬	TMDX
辋	LMUN
趾	KHHG
腓	EDJD
腱	EVFP
瘀	UYWU
簧	TAMW
喉	KWND
嫖	VSFI
娼	VJJG
翌	NUF
乞	TNB
蝌	JTUF
蚪	JUFH
绷	XEEG
怯	NFCY
珩	GTFH
瓣	URCU
暄	JPGG
忏	NTFH
忐	HNU
忑	GHNU
粽	OPFI
肴	QDEF
糯	OFDJ
尉	NFIF
蜕	JUKQ
滔	IEVG
姝	VRIY
孱	NBBB
咐	KWFY
瑶	GERM
蹒	KHAW
跚	KHMG
醋	SGAJ
赘	GQTM
噼	KNKU
啪	KRRG
熔	OPWK
孵	QYTB
嘀	KUMD
咕	KDG
嗣	KMAK
炳	OGMW
藩	AITL
脍	EWFC
玘	GNN
娥	VTRT
聂	BCCU
懿	FPGN
瘐	UVWI
庾	YVWI
遽	HAEP
惬	NAGW
獒	GQTD
拴	RWGG
嗷	KGQT
唠	KAPL
浃	IGUW
褛	PUOV
琍	GTJH
兀	GQV
雌	HXWY
吭	KYMN
犁	TJRH
窘	PWVK
匡	AGD
札	SNN
桢	SHMY
濂	IYUO
鏊	GQTQ
徵	TMGT
庵	YDJN
铎	QCFH
墉	FYVH
绶	XEPC
阙	UUBW
骞	PFJC
篆	TXEU
髡	DEGQ
杵	STFH
嫡	VUMD
敷	GEHT
蕊	ANNN
媾	VFJF
氓	YNNA
痞	UGIK
磺	DAMW
涕	IUXT
荟	AWFC
仄	DWI
慵	NYVH
褥	PUDF
嘬	KJBC
腮	ELNY
咿	KWVT
赐	MJQR
薯	ALFJ
獐	QTUJ
汛	INFH
羌	UDNB
羹	UGOD
佻	WIQN
阱	BFJH
赀	HXMU
茱	ARIU
徙	THHY
娩	VQKQ
鸽	WGKG
勺	QYI
搡	RCCS
浚	ICWT
吆	KXY
眩	HYXY
灸	QYOU
纾	XCBH
饪	QNTF
婿	VNHE
弛	XBN
篡	THDC
龋	HWBY
嫦	VIPH
毙	XXGX
拈	RHKG
寐	PNHI
鞭	AFWQ
匾	AYNA
沓	IJF
冗	PMB
裆	PUIV
搓	RUDA
刁	NGD
咫	NYKW
黏	TWIK
蜿	JPQB
蜒	JTHP
伫	WPGG
沱	IPXN
贰	AFMI
鹜	CBTG
抡	RWXN
箔	TIRF
钓	QQYY
夥	JSQQ
讥	YMN
禄	PYVI
飓	MQHW
傀	WRQC
儡	WLLL
诙	YDOY
廓	YYBB
禾	TTTT
仟	WTFH
涪	IUKG
嗨	KITU
撺	RPWH
掇	RCCC
侬	WPEY
亵	YRVE
唳	KYND
叱	KXN
咤	KPTA
掰	RWVR
侏	WRIY
锥	QWYG
匣	ALK
囫	LQRE
囵	LWXV
辊	LJXX
昝	THJF
谧	YNTL
攘	RYKE
蹭	KHUJ
裴	DJDE
翕	WGKN
砺	DDDN
兖	UCQB
窑	PWRM
蚌	JDHH
埠	FWNF
敖	GQTY
榕	SPWK
鹭	KHTG
昱	JUF
妤	VCBH
炅	JOU
枭	QYNS
潞	IKHK
毓	TXGQ
皑	RMNN
峭	MIEG
鲸	QGYI
邬	QNGB
擞	ROVT
镌	QWYE
嘎	KDHA
遴	OQAP
晾	JYIY
羸	YNKY
淄	IVLG
诏	YVKG
潼	IUJF
嵬	MRQC
丞	BIGF
羰	UDMO
酐	SGFH
氮	RNOO
氩	RNGG
埕	FKGG
矣	CTDU
眈	HPQN
祠	PYNK
衙	TGKH
氟	RNXJ
琐	GIMY
邗	FBH
迩	QIPI
贻	MCKG
掠	RYIY
泞	IPSH
孪	YOBF
霹	FNKU
雳	FDLB
翱	RDFN
跤	KHUQ
蟾	JQDY
瑾	GAKG
刨	QNJH
痂	ULKD
沥	IDLN
恣	UQWN
滂	IUPY
孜	BTY
嬿	VAUO
瑄	GPGG
葆	AWKS
潺	INBB
惮	NUJF
旼	JYY
梵	SSMY
缎	XWDC
闾	UKKD
胭	ELDY
闫	UDD
邝	YBH
孀	VFSH
骅	CWXF
冽	UGQJ
椭	SBDE
褶	PUNR
喋	KANS
诓	YAGG
芸	AFCU
鸳	QBQG
鸯	MDQG
瑚	GDEG
栀	SRGB
峪	MWWK
锏	QUJG
稼	TPEY
锄	QEGL
罡	LGHF
踱	KHYC
蔑	ALDT
荼	AWTU
骕	CVIJ
峨	MTRT
亥	YNTW
弼	XDJX
涿	IEYY
猖	QTJJ
獗	QTDW
囱	TLQI
阜	WNNF
碉	DMFK
垡	WAFF
暐	JNHH
咝	KXXG
蠖	JAWC
嗍	KUBE
颍	XIDM
赡	MQDY
苁	AWWU
蛭	JGCF
岢	MSKF
蚍	JXXN
鸷	RVYG
稹	TFHW
嗡	KWCN
瞥	UMIH
邯	AFBH
郸	UJFB
笈	TEYU
霏	FDJD
烁	OQIY
蛙	JFFG
璞	GOGY
撩	RDUI
瞳	HUJF
峤	MTDJ
郴	SSBH
漳	IUJH
崴	MDGT
煽	OYNN
锘	QADK
恪	NTKG
靳	AFRH
幌	MHJQ
窟	PWNM
唰	KNMJ
锢	QLDG
燎	ODUI
搔	RCYJ
烩	OWFC
蜚	DJDJ
歼	GQTF
铨	QWGG
哓	KATQ
呕	KAQY
龑	UEGD
哆	KQQY
嗦	KFPI
湃	IRDF
膂	YTEE
鸵	QYNX
祟	BMFI
肓	YNEF
蝎	JJQN
龟	QJNB
刎	QRJH
栈	SGT
铠	QMNN
狡	QTUQ
黠	LFOK
茁	ABMJ
痣	UFNI
唔	KGKG
泅	ILWY
婺	CBTV
漾	IUGI
锲	QDHD
睬	HESY
窒	PWGF
岔	WVMJ
馗	VUTH
巳	NNGN
酉	SGD
戌	DGNT
娆	VATQ
俘	WEBG
栢	SDJG
尕	EIU
怿	NCFH
魇	DDRC
桓	SGJG
肪	EYN
鱀	VCAO
豚	EEY
霭	FYJN
蔼	AYJN
侄	WGCF
嬴	YNKY
爪	RHYI
壕	FYPE
孽	AWNB
妾	UVF
跺	KHMS
槟	SPRW
陞	BTAF
跆	KHCK
奂	QMDU
狰	QTQH
狞	QTPS
涸	ILDG
柽	SCFG
嬷	VYSC
羚	UDWC
牒	THGS
鳍	QGFJ
蛎	JDDN
憔	NWYO
悴	NYWF
啃	KHEG
迂	GFPK
侥	WATQ
鞘	AFIE
偌	WADK
曜	JNWY
泷	IDXN
鲲	QGJX
讧	YAG
褂	PUFH
涮	INMJ
坂	FRCY
噶	KAJN
剃	UXHJ
燮	OYOC
戍	DYNT
咙	KDXN
胯	EDFN
酗	SGQB
疚	UQYI
猾	QTME
铐	QFTN
拧	RPSH
叨	KVN
瞎	HPDK
诬	YAWW
迢	VKPD
笙	TTGF
旌	YTTG
袤	YCBE
汊	ICYY
幄	MHNF
堑	LRFF
髯	DEMF
岖	MAQY
隘	BUWL
冉	MFD
霓	FVQB
颦	HIDF
蜢	JBLG
涟	ILPY
漪	IQTK
臧	DNDT
沅	IFQN
屿	MGNG
擒	RWYC
祎	PYFH
旻	JYU
翚	NPLJ
伽	WLKG
猿	QTFE
茗	AQKF
褔	PUGL
倔	WNBM
嫣	VGHO
渶	IAMD
祐	PYDK
宥	PDEF
喱	KDJF
疹	UWEE
僚	WDUI
蹋	KHJN
裳	IPKE
焉	GHGO
嗔	KFHW
琵	GGXX
琶	GGCB
彗	DHDV
拽	RJXT
胰	EGXW
崽	MLNU
溅	IMGT
暻	JJYI
谬	YNWE
睾	TLFF
裱	PUGE
笋	TVTR
蜻	JGEG
蜓	JTFP
庇	YXXV
葫	ADEF
芦	AYNR
镭	QFLG
雹	FQNB
巿	GMHK
镖	QSFI
谄	YQVG
锕	QBSK
灞	IFAE
幺	XNNY
檐	SQDY
螳	JIPF
螂	JYVB
翊	UNG
嘚	KTJF
攸	WHTY
骥	CUXW
忒	ANI
坷	FSKG
侑	WDEG
徜	TIMK
徉	TUDH
梆	SDTB
秧	TMDY
摁	RLDN
糗	OTHD
琎	GFJP
猬	QTLE
戕	NHDA
犇	RHTH
俚	WJFG
蹴	KHYN
臼	VTHG
颌	WGKM
咆	KQNN
哮	KFTB
苓	AWYC
萸	AVWU
藕	ADIY
驩	CAKY
钝	QGBN
靶	AFCN
痼	ULDD
呱	KRCY
佢	WANG
搵	RLWL
罔	MUYN
沌	IGBN
诃	YSKG
粱	IVWO
棠	IPKS
陂	BHCY
滘	IPWK
岐	MFCY
狙	QTEG
涣	IQMD
煲	WKSO
兮	WGNB
赧	FOBC
馑	QNAG
黝	LFOL
掸	RUJF
蜷	JUDB
吮	KCQN
凋	UMFK
骊	CGMY
嫔	VPRW
芪	AQAB
锺	QTGF
糅	OCBS
颚	KKFM
濡	IFDJ
殉	GQQJ
坟	FYY
戎	ADE
畑	OLG
濑	IGKM
绢	XKEG
哟	KXQY
帚	VPMH
仨	WDG
嗖	KVHC
缰	XGLG
噌	KULJ
咣	KIQN
酥	SGTY
绌	XBMH
龌	HWBF
龊	HWBH
呦	KXLN
陲	BTGF
杞	SNN
渲	IPGG
頔	MDMY
峄	MCFH
阖	UFCL
凫	QYNM
姵	VMGH
岱	WAMJ
蝇	JKJN
臃	EYXY
昉	JYN
柚	SMG
邸	QAYB
拂	RXJH
敕	GKIT
砚	DMQN
鬟	DELE
玳	GWAY
瑁	GJHG
婵	VUJF
愍	NATN
忼	NYMN
蛾	JTRT
逡	CWTP
魑	RQCC
彝	XGOA
擘	NKUR
笺	TGR
薏	AUJN
苡	ANYW
甥	TGLL
爇	AFWO
鷇	FPDC
溟	IPJU
豕	EGTY
壅	YXTF
茯	AWDU
吏	GKQI
濯	INWY
谪	YUMD
怅	NTAY
稗	TRTF
畦	LFFG
筵	TTHP
屐	NTFC
讹	YWXN
舫	TEYN
埴	FFHG
荦	APRH
樽	SUSF
泖	IQTB
殳	MCU
雠	WYYY
阕	UWGD
赆	MNYU
祚	PYTF
忤	NTFH
夙	MGQI
莵	ATKY
谥	YUWL
浣	IPFQ
绡	XIEG
簪	TAQJ
鹃	KEQG
炷	OYGG
骡	CLXI
苕	AVKF
辇	FWFL
柙	SLH
鼐	EHNN
芍	AQYU
醺	SGTO
揄	RWGJ
鼙	FKUF
谏	YGLI
劾	YNTL
桧	SWFC
谲	YCBK
皤	RTOL
庶	YAOI
纨	XVYY
歙	WGKW
缢	XUWL
戊	DNYT
钺	QANT
衾	WYNE
僖	WFKK
羯	UDJN
矜	CBTN
郋	THBH
妲	VJGG
抔	RGIY
倏	WHTD
缜	XFHW
玠	GWJH
嶙	MOQH
犰	QTVN
狳	QTWT
犸	QTCG
碛	DGMY
璀	GMWY
璨	GHQO
俺	WDJN
拣	RANW
秃	TMB
痰	UOOI
檄	SRYT
酵	SGFB
毡	TFNK
熘	OQYL
埂	FGJQ
綦	ADWI
镰	QYUO
鬲	GKMH
讣	YHY
阑	UGLI
撸	RQGJ
揶	RBBH
邴	GMWB
纫	XVYY
鱿	QGDN
缚	XGEF
捱	RDFF
篱	TYBC
牦	TRTN
撵	RFWL
悻	NFUF
呛	KWBN
膑	EPRW
隼	WYFJ
逄	TAHP
劭	VKLN
怦	NGUH
祀	PYNN
甭	GIEJ
呗	KMY
鼬	VNUM
咛	KPSH
蒨	AWGE
牯	TRDG
寃	PQKY
琭	GVIY
沢	INYY
陛	BXXF
髋	MEPQ
桔	SFKG
崚	MFWT
舛	QAHH
骢	CTLN
囔	KGKE
髻	DEFK
瞭	HDUI
搀	RQKU
揩	RXXR
幡	MHTL
湟	IRGG
鸰	WYCG
嫱	VFUK
秣	TGSY
喔	KNGF
榷	SPWY
拄	RYGG
碜	DCDE
揍	RDWD
酪	SGTK
酶	SGTU
唢	KIMY
疙	UTNV
瘩	UAWK
咯	KTKG
噔	KWGU
蒜	AFII
噗	KOGY
嗤	KBHJ
娑	IITV
烜	OGJG
颀	RDMY
坳	FXLN
蒽	ALDN
圜	LLGE
悱	NDJD
恻	NMJH
倜	WMFK
傥	WIPQ
噜	KQGJ
雉	TDWY
奄	DJNB
盹	HGBN
琅	GYVE
堀	FNBM
玹	GYXY
阂	UYNW
胍	ERCY
脲	ENIY
棺	SPNN
缄	XDGT
玷	GHKG
隍	BRGG
耙	DICN
鞠	AFQO
瞠	HIPF
葳	ADGT
蛊	JLF
瞟	HSFI
诘	YFKG
帧	MHHM
轲	LSKG
戮	NWEA
荤	APLJ
柿	SYMH
黢	LFOT
唁	KYG
醚	SGOP
芷	AHF
晞	JQDH
蔫	AGHO
赉	GOMU
鹑	YBQG
赦	FOTY
蹬	KHWU
溉	IVCQ
尓	TIU
嵘	MAPS
峦	YOMJ
鹄	TFKG
旖	YTDK
旎	YTNX
侪	WYJH
岿	MJVF
瓴	WYCN
椽	SXEY
璜	GAMW
祓	PYDC
袴	PUDN
衽	PUTF
裥	PUUJ
崧	MSWC
煅	OWDC
滦	IYOS
枧	SMQN
痫	UUSI
帼	MHLY
畲	WFIL
飨	XTWE
汭	IMWY
啰	KLQY
瘁	UYWF
踯	KHUB
躅	KHLJ
聩	BKHM
胚	EGIG
叽	KMN
璠	GTOL
韫	FNHL
蜈	JKGD
蚣	JWCY
俶	WHIC
墩	FYBT
馍	QNAD
懵	NALH
憩	TDTN
锚	QALG
瘠	UIWE
蚬	JMQN
瑙	GVTQ
涧	IUJG
鳟	QGUF
鲈	QGHN
瀑	IJAI
葱	AQRN
湍	IMDJ
橇	STFN
铛	QIVG
闰	UGD
黜	LFOM
捎	RIEG
烃	OCAG
懦	NFDJ
霎	FUVF
栾	YOSU
诅	YEGG
饵	QNBG
虾	JGHY
昀	JQUG
蘅	ATQH
疱	UQNV
胄	MEF
酩	SGQK
酊	SGSH
糜	YSSO
缮	XUDK
渑	IKJN
阏	UYWU
唛	KGTY
膦	EOQH
鼍	KKLN
磬	FNMD
钹	QDCY
脓	EPEY
毗	LXXN
谘	YUQK
贲	FAMU
铤	QTFP
剌	GKIJ
焙	OUKG
蹇	PFJH
咦	KGXW
楞	SLYN
碴	DSJG
圌	LMDJ
崮	MLDF
淬	IYWF
癀	UAMW
吒	KTAN
钜	QANG
菘	ASWC
铱	QYEY
皿	LHNG
盅	KHLF
沣	IDHH
篓	TOVF
缱	XKHP
绻	XUDB
薜	ANKU
恁	WTFN
卅	GKK
蟒	JADA
伢	WAHT
咩	KUDH
恸	NFCL
咀	KEGG
帛	RMHJ
钕	QVG
硼	DEEG
圻	FRH
螨	JAGW
谟	YAJD
揸	RSJG
胛	ELH
芴	AQRR
眭	HFFG
铢	QRIY
垢	FRGK
祘	FIFI
渥	INGF
娸	VADW
幷	TFTF
葺	AKBF
砷	DJHH
硒	DSG
浜	IRGW
煊	OPGG
捌	RKLJ
柒	IASU
甾	VLF
屾	MMH
琏	GLPY
鲤	QGJF
昳	JRWY
喳	KSJG
鼹	VNUV
酹	SGEF
褚	PUFJ
翥	FTJN
蟠	JTOL
榛	SDWT
糠	OYVI
畿	XXAL
氹	NII
叁	CDDF
骰	MEMC
鳖	UMIG
聃	BMFG
児	HJQB
涓	IKEG
拃	RTHF
脯	EGEY
丐	GHNV
訾	HXYF
踮	KHYK
殓	GQWI
辕	LFKE
蝰	JDFF
怵	NSYY
娲	VKMW
诶	YCTD
茧	AJU
蹉	KHUA
跎	KHPX
皋	RDFJ
氰	RNGE
呑	TDKF
呷	KLH
顼	GDMY
雒	TKWY
铧	QWXF
礐	WFQD
粪	OAWU
埸	FJQR
歺	HQU
哏	KVEY
吱	KFCY
揠	RAJV
蝗	JRGG
璩	GHAE
赝	DWWM
噤	KSSI
铰	QUQY
洺	IQKG
荀	AQJF
迦	LKPD
泱	IMDY
铀	QMG
噎	KFPU
凛	UYLI
朽	SGNN
翎	WYCN
熨	NFIO
蛹	JCEH
忿	WVNU
獾	QTAY
淦	IQG
寮	PDUI
醍	SGJH
醐	SGDE
愠	NJLG
趔	FHGJ
趄	FHEG
碾	DNAE
湔	IUEJ
怂	WWNU
恿	CENU
湮	ISFG
暌	JWGD
扪	RUN
镝	QUMD
焜	OJXX
嘈	KGMJ
踟	KHTK
蹰	KHDF
抿	RNAN
枷	SLKG
荪	ABIU
槃	TEMS
椋	SYIY
翀	NKHH
螯	GQTJ
颧	AKKM
嬲	LLVL
揾	RJLG
奘	NHDD
蒺	AUTD
藜	ATQI
搥	RWNP
遨	GQTP
愫	NGXI
喟	KLEG
跛	KHHC
鉄	QRWY
毽	TFNP
潟	IVQO
瓢	SFIY
蚱	JTHF
盥	QGIL
侉	WDFN
讴	YAQY
璋	GUJH
炀	ONRT
鹍	JXXG
蹑	KHBC
戗	WBAT
芥	AWJJ
眬	HDXN
箩	TLQU
嚏	KFPH
嫒	VEPC
蓁	ADWT
锜	QDSK
窠	PWJS
坨	FPXN
骼	METK
飑	MQQN
桅	SQDB
舸	TESK
咂	KAMH
樨	SNIH
劵	UDLB
俬	WTCY
犄	TRDK
镤	QOGY
纣	XFY
宦	PAHH
腴	EVWY
碓	DWYG
恹	NDDY
嬗	VYLG
惆	NMFK
衩	PUCY
樵	SWYO
佚	WRWY
绛	XTAH
龅	HWBN
鸥	AQQG
芃	AMYU
镒	QUWL
耄	FTXN
耋	FTXF
瞌	HFCL
痿	UTVD
嗒	KAWK
痈	UEK
嵇	TDNM
蹼	KHOY
骸	MEYW
氦	RNYW
皈	RRCY
痨	UAPL
钏	QKH
珞	GTKG
琤	GQVH
郏	GUWB
楂	SSJG
榔	SYVB
読	YFPQ
売	FPQB
荑	AGXW
呃	KDBN
聿	VFHK
踺	KHVP
泠	IWYC
苜	AHF
蓿	APWJ
怄	NAQY
厝	DAJD
甗	HAGN
砧	DHKG
玦	GNWY
訇	QYD
瞑	HPJU
绔	XDFN
庹	YANY
丕	GIGF
鲟	QGVF
鄱	TOLB
臬	THSU
曽	ULJF
煳	ODEG
唿	KQRN
囹	LWYC
圄	LGKD
荨	AVFU
簌	TGKW
杓	SQYY
洄	ILKG
萼	AKKN
胥	NHEF
獭	QTGM
饴	QNCK
遁	RFHP
唑	KWWF
峋	MQJG
邺	OGBH
菅	APNN
尻	NVV
菏	AISK
郓	PLBH
炣	OSKG
犒	TRYK
癸	WGDU
籼	OMH
锱	QVLG
蹩	UMIH
蠕	JFDJ
蕨	ADUW
嘹	KDUI
蜇	RRJU
荥	APIU
竽	TGFJ
斡	FJWF
枳	SKWY
诿	YTVG
氋	APGN
旸	JNRT
帙	MHRW
罅	RMHH
嵊	MTUX
啧	KGMY
儆	WAQT
疝	UMK
忾	NRNN
鲫	QGVB
怆	NWBN
揖	RKBG
谰	YUGI
轼	LAAG
庖	YQNV
迳	CAPD
鄄	SFBH
搐	RYXL
僮	WUJF
怏	NMDY
辘	LYNX
轳	LHNT
哝	KPEY
髂	MEPK
徇	TQJG
戾	YNDI
犟	XKJH
莒	AKKF
怔	NGHG
婊	VGEY
贽	RVYM
涞	IGOY
犊	TRFD
馄	QNJX
饨	QNGN
褭	YCEU
彖	XEU
敝	UMIT
瓮	WCGN
缶	RMK
杲	JSU
瑹	GAWT
箕	TADW
羖	UDMC
穑	TFUK
汴	IYHY
诲	YTXU
棂	SVOY
舔	TDGN
叟	VHCU
祼	PYJS
璘	GOQH
囧	LWMV
祛	PYFC
糨	OXKJ
爻	QQU
栉	SABH
溥	IGEF
馋	QNQU
撅	RDUW
捋	REFY
佯	WUDH
淖	IHJH
骝	CQYL
屌	NKMH
骧	CYKE
椁	SYBG
鎏	IYCQ
嗲	KWQQ
呯	KGUH
疣	UDNV
牠	TRBN
惘	NMUN
爨	WFMO
瓤	YKKY
鸫	AIQG
秫	TSYY
繋	LMCI
塙	FYMK
椿	SDWJ
謡	YERM
円	MHGD
菂	ARQY
噫	KUJN
蹙	DHIH
怃	NFQN
猥	QTLE
湎	IDMD
硌	DTKG
罂	MMRM
粟	SOU
蓦	AJDC
弢	XBHC
婢	VRTF
郛	EBBH
倻	WBBH
唬	KHAM
吖	KUHH
黟	LFOQ
佗	WPXN
籽	OBG
苇	AFNH
晌	JTMK
孖	BBG
谕	YWGJ
阄	UQJN
莴	AKMW
篝	TFJF
舀	EVF
抺	RFIY
酚	SGWV
攫	RHHC
葹	AYTB
钤	QWYN
俍	WYVE
洮	IIQN
俾	WRTF
粳	OGJQ
菠	AIHC
菀	APQB
狒	QTXJ
剐	KMWJ
酖	SGPQ
漕	IGMJ
搧	RYNN
煟	OLEG
遒	USGP
辏	LDWD
厍	DLK
呲	KHXN
哒	KDPY
哋	KFBN
咗	KDAG
喺	KWTI
嘅	KVCQ
矸	DFH
氤	RNLD
氲	RNJL
耒	DII
炻	ODG
鸲	QKQG
锑	QUXT
煕	AHHO
蓥	APQF
呸	KGIG
茴	ALKF
茎	ACAF
楺	SCBS
嶋	MWVO
惇	NYBG
荄	AYNW
辍	LCCC
豢	UDEU
侩	WWFC
痘	UGKU
棹	SHJH
芊	ATFJ
樯	SFUK
锹	QTOY
镙	QLXI
嘣	KMEE
鳃	QGLN
忖	NFY
珣	GQJG
倌	WPNN
廨	YQEH
蓈	AYVB
淞	ISWC
孺	BFDJ
攞	RLXY
刈	QJH
阋	UVQV
匍	QGEY
匐	QGKL
襁	PUXJ
褓	PUWS
邰	CKBH
鸩	PQQG
纂	THDI
牐	THGV
犓	TRQT
淙	IPFI
舷	TEYX
贳	ANMU
馀	QNWT
骠	CSFI
朕	EUDY
佞	WFVG
钣	QRCY
犍	TRVP
戞	DEPA
楮	SFTJ
抻	RJHH
鬣	DEVN
烊	OUDH
焯	OHJH
吠	KDY
呻	KJHH
怩	NNXN
憟	NSOY
畈	LRCY
俫	WGOY
喙	KXEY
裰	PUCC
靛	GEPH
氅	IMKN
獠	QTDI
啭	KLFY
鞅	AFMD
镉	QGKH
烬	ONYU
噁	KGHN
喵	KALG
樋	SCEP
疟	UAGD
箧	TAGW
耷	DBF
忟	NYY
藐	AEEQ
撷	RFKM
绺	XTHK
啵	KIHC
虱	NTJI
惴	NMDJ
珐	GFCY
壬	TFD
氐	QAYI
蛏	JCFG
枸	SQKG
掮	RYNE
婓	DJDV
皞	RRDF
暎	JAMD
嵴	MIWE
笆	TCB
柑	SAFG
耆	FTXJ
诹	YBCY
菖	AJJF
椹	SADN
捭	RRTF
蛄	JDG
鳅	QGTO
韭	DJDG
枇	SXXN
杷	SCN
郞	YVEB
俣	WKGD
弑	QSAA
痧	UIIT
胴	EMGK
蠡	XEJJ
鵰	MFKO
稔	TWYN
搽	RAWS
炆	OYY
旃	YTMY
泫	IYXY
垩	GOGF
豌	GKUB
眛	HFIY
邨	GBNB
荛	AATQ
挞	RDPY
胱	EIQN
琬	GPQB
骶	MEQY
鋆	FQUQ
楝	SGLI
忸	NNFG
瓈	GTQI
饍	WYVK
洧	IDEG
铖	QDNT
恃	NFFY
铡	QMJH
聒	BTDG
彅	XUEV
堺	FLWJ
犌	TRNC
嗄	KDHT
伡	WLH
吡	KXXN
臊	EKKS
耨	DIDF
梃	STFP
谶	YWWG
擢	RNWY
沺	ILG
熀	OJIQ
坻	FQAY
秭	TTNT
篼	TQRQ
暪	JAMY
厣	DDLK
醵	SGHE
丶	YYLL
呤	KWYC
啾	KTOY
崂	MAPL
煦	JQKO
糸	XIU
噙	KWYC
箴	TDGT
煴	OJLG
咴	KDOY
诖	YFFG
鲎	IPQG
熓	OWNO
缌	XLNY
熥	OCEP
瑀	GTKY
蚝	JTFN
畚	CDLF
鼾	THLF
曺	GMJF
侗	WMGK
仡	WTNN
佝	WQKG
偻	WOVG
仞	WVYY
滁	IBWT
妪	VAQY
揆	RWGD
钡	QMY
锶	QLNY
鞑	AFDP
靼	AFJG
馐	QNUF
懑	IAGN
嘭	KFKE
瘴	UUJK
纡	XGFH
鹘	MEQG
嫄	VDRI
菡	ABIB
袅	QYNE
殚	GQUF
衲	PUMW
橼	SXXE
铑	QFTX
钿	QLG
偲	WLNY
仝	WAF
鲢	QGLP
鲼	QGFM
澧	IMAU
饬	QNTL
喯	KDFA
嗝	KGKH
岜	MCB
锝	QJGF
鹬	CBTG
逵	FWFP
镈	QGEF
垅	FDXN
嵋	MNHG
琮	GPFI
颉	FKDM
俸	WDWH
炔	ONWY
肱	EDCY
倭	WTVG
蒐	ARQC
蛐	JMAG
旮	VJF
旯	JVB
谡	YLWT
楫	SKBG
诨	YPLH
碘	DMAW
腌	EDJN
腭	EKKN
鹗	KKFG
厩	DVCQ
葚	AADN
锒	QYVE
驮	CDY
蛞	JTDG
蝓	JWGJ
锟	QJXX
柩	SAQY
虻	JYNN
蛳	JJGH
腘	ELGY
唧	KVCB
麋	YNJO
瀬	IGKM
阉	UDJN
尅	DQFI
孬	GIVB
佃	WLG
仃	WSH
髌	MEPW
竦	UGKI
棻	AWVS
颔	WYNM
涔	IMWN
鬃	DEPI
毳	TFNN
膻	EYLG
赭	FOFJ
歓	RWYW
谒	YJQN
轭	LDBN
痢	UTJK
镓	QPEY
雩	FFNB
玎	GSH
鸾	YOQG
瓒	GTFM
稞	TJSY
擤	RTHJ
笄	TGAJ
螭	JYBC
篪	TRHM
囿	LDED
倞	WYIY
恂	NQJG
癞	UGKM
铼	QGOY
豺	EEFT
瑨	GGOJ
钽	QJGG
跶	KHDP
苋	AMQB
筚	TXXF
茌	AWFF
檡	SLFF
浈	IHMY
璎	GMMV
呓	KANN
肛	EAG
娉	VMGN
镗	QIPF
豉	GKUC
粑	OCN
蘸	ASGO
铌	QNXN
耦	DIJY
蓑	AYKE
汨	IJG
麈	YNJG
鹌	DJNG
剁	MSJH
勐	BLLN
裾	PUND
漭	IADA
喹	KDFF
缬	XFKM
瘙	UCYJ
綮	YNTI
筅	TTFQ
粞	OSG
燧	OUEP
艮	VEI
泮	IUFH
薅	AVDF
嶂	MUJH
逶	TVPD
迤	TBPV
碚	DUKG
茸	ABF
焖	OUNY
豊	MAGU
榖	FPTC
瘮	UCCE
芩	AWYN
彀	FPGC
锉	QWWF
瘊	UWND
囝	LBD
荚	AGUW
黐	TWIC
呖	KDLN
刽	WFCJ
荇	ATFH
铟	QLDY
戢	KBNT
颋	TFPM
叵	AKD
咲	KUDY
镣	QDUI
喁	KJMY
鹣	UVOG
鲽	QGAS
歘	OOOW
韪	JGHH
谌	YADN
跗	KHWF
捻	RWYN
霈	FIGH
佺	WWGG
邕	VKCB
蜍	JWTY
鏸	QGJN
笸	TAKF
鹈	UXHG
鹕	DEQG
爲	ETNO
嚐	KIPJ
裵	YDJE
轸	LWET
硖	DGUW
溧	ISSY
熵	OUMK
睥	HRTF
睨	HVQN
疴	USKD
癔	UUJN
鲔	QGDE
馕	QNGE
笕	TMQB
檎	SWYC
鲴	QGLD
茺	AYCQ
塚	FPEY
鲋	QGWF
薷	AFDJ
鞴	AFAE
嬬	VFDJ
仵	WTFH
鲵	QGVQ
蓟	AQGJ
泔	IAFG
郄	QDCB
浛	IWYK
阡	BTFH
漉	IYNX
矬	TDWF
痔	UFFI
叻	KLN
鹳	AKKG
羟	UDCA
掽	RUOG
肞	ECYY
谆	YYBG
掟	RPGH
跣	KHTQ
楯	SRFH
効	UQLN
哐	KAGG
觞	QETR
垛	FMSY
捯	RGCJ
趵	KHQY
嚭	FKUK
谞	YNHE
粲	HQCO
氘	RNJJ
氚	RNKJ
锃	QKGG
萑	AWYF
睱	HNHC
忪	NWCY
凇	USWC
褫	PURM
睑	HWGI
坭	FNXN
鏂	QAKK
濇	IFWK
芈	GJGH
岘	MMQN
晁	JIQB
郇	QJBH
硚	DTDJ
妣	VXXN
喑	KUJG
摭	RYAO
肄	XTDH
莳	AJFU
猷	USGD
镏	QQYL
晸	JGHT
垭	FGOG
楹	SECL
墒	FUMK
箐	TGEF
罘	LGIU
崑	MJXX
祇	PYQA
瑠	GQYL
骈	CUAH
箦	TGMU
悭	NJCF
佤	WGNN
岬	MLH
盱	HGFH
眙	HCKG
筲	TIEF
湫	ITOY
噘	KDUW
蹚	KHIF
饷	QNTK
笞	TCKF
螟	JPJU
腈	EGEG
啉	KSSY
篾	TLDT
奁	DAQU
芨	AEYU
麝	YNJF
笏	TQRR
稷	TLWT
矽	DQY
啲	KRQY
谂	YWYN
砭	DTPY
钚	QGIY
诌	YQVG
壸	FPGG
蕲	AUJR
颛	MDMM
喾	IPTK
寯	PWYM
盃	GILF
墚	FIVS
俳	WDJD
闱	UFNH
俟	WCTD
埭	FVIY
犮	DCU
苷	AAFF
鳐	QGEM
璈	GGQT
劢	DNLN
诒	YCKG
崟	MQF
碣	DJQN
褡	PUAK
裢	PULP
渟	IYPS
佷	WVEY
璺	WFMY
傧	WPRW
腚	EPGH
旒	YTYQ
瘢	UTEC
疸	UJGD
嚯	KFWY
鄯	UDUB
勳	TGLL
龃	HWBG
龉	HWBK
邙	YNBH
霰	FAET
馊	QNVC
觚	QERY
隈	BLGE
笪	TJGF
渚	IFTJ
逹	FUFP
戆	UJTN
钌	QBH
焘	DTFO
僭	WAQJ
恽	NPLH
隗	BRQC
妯	VMG
娌	VJFG
鸢	AQYG
盂	GFLF
硐	DMGK
柘	SDG
咁	KAFG
颢	JYIM
埼	FDSK
沇	ICQN
蹟	KHGM
跖	KHDG
錡	QDSK
囍	FKUK
嗬	KAWK
慾	WWKN
澹	IQDY
暹	JWYP
芫	AFQB
骱	MEWJ
袪	PUFC
苌	ATAY
葶	AYPS
麸	GQFW
驽	VCCF
讦	YFH
诳	YQTG
譠	YYLG
丨	HHLL
榣	SERM
砒	DXXN
啮	KHWB
璆	GNWE
乣	XNN
赜	AHKM
秞	TMG
嶶	MTMT
姹	VPTA
堇	AKGF
陟	BHIT
窨	PWUJ
萋	AGVV
郗	QDMB
啄	KEYY
虬	JNN
玶	GGUH
桠	SGOG
鲧	QGTI
庥	YWSI
郢	KGBH
珅	GJHH
坜	FDLN
凖	UWYF
劼	FKLN
眀	HEG
苴	AEGF
缂	XAFH
褙	PUUE
罨	LDJN
挈	DHVR
珧	GIQN
滓	IPUH
矾	DMYY
芘	AXXB
喏	KADK
焗	ONNK
晳	SRJF
袓	PUEG
茭	AUQU
剜	PQBJ
谀	YVWY
逑	FIYP
骀	CCKG
勖	JHLN
殁	GQMC
脷	ETJH
哂	KSG
芡	AQWU
裇	PUTL
缛	XDFF
嘞	KAFL
枥	SDLN
苾	ANTR
皲	PLHC
勲	TGJO
扦	RTFH
伥	WTAY
砣	DPXN
媞	VJGH
簋	TVEL
翦	UEJN
嫚	VJLC
篙	TYMK
糼	XLN
馔	QNNW
桴	SEBG
诮	YIEG
鹧	YAOG
鸪	DQYG
蚧	JWJH
鬈	DEUB
宓	PNTR
槲	SQEF
亓	FJJ
鞣	AFCS
瓅	GXRS
杼	SCBH
谵	YQDY
珪	GFFG
橹	SQGJ
铪	QWGK
嗵	KCEP
桁	STFH
沏	IAVN
欷	QDMW
歔	HAOW
髹	DEWS
冦	PFQC
楸	STOY
媗	VPGG
吲	KXHH
愦	NKHM
巯	CAYQ
呔	KDYY
耈	FTXK
呙	KMWU
妬	VDG
炤	OVKG
毖	XXNT
樗	SFFN
钭	QUFH
凃	UWTY
寤	PNHK
俅	WFIY
镴	QVLN
椴	SWDC
谗	YQKU
黉	IPAW
铋	QNTT
驷	CLG
鲥	QGJF
疥	UWJK
蛔	JLKG
餍	DDWE
虼	JTNN
嗟	KUDA
蛘	JUDH
簦	TWGU
癏	ULGE
桼	SWIU
寳	PGQM
埙	FKMY
禇	PYFJ
骎	CVPC
梿	SLPY
襌	PUKF
癯	UHHY
潚	IVHH
溘	IFCL
屺	MNN
渖	IPJH
钎	QTFH
饔	YXTE
氖	RNEB
媸	VBHJ
镫	QWGU
蘧	AHAP
荞	ATDJ
闳	UDCI
琇	GTEN
礩	DRRM
槙	SFHW
嘤	KMMV
謦	FNMY
逦	GMYP
鲭	QGGE
泆	IRWY
槻	SFWQ
玑	GMN
芤	ABNB
嬖	NKUV
谝	YYNA
馼	CYY
挹	RKCN
誊	UDYF
荜	AXXF
轱	LDG
愆	TIFN
牝	TRXN
盬	AHNL
飧	QWYE
癜	UNAC
盍	FCLF
褊	PUYA
翏	NWER
尢	DNV
暝	JPJU
卮	RGBV
僬	WWYO
熳	OJLC
苣	AANF
旆	YTGH
嗌	KUWL
鞯	AFAB
鞒	AFTJ
蛉	JWYC
阒	UHDI
芾	AGMH
醮	SGWO
牎	THGN
荠	AYJJ
偾	WFAM
苫	AHKF
蹽	KHDI
説	YUKQ
佀	WHNN
棰	STGF
楢	SUSG
啓	YNTK
蒹	AUVO
涘	ICTD
沚	IHG
蜉	JEBG
摺	RNRG
渕	IUDJ
垌	FMGK
兟	TFQQ
砵	DSGG
撗	RAMW
荸	AFPB
镪	QXKJ
擀	RFJF
蠹	GKHJ
臖	WFME
盿	HYY
槿	SAKG
肫	EGBN
査	SEGF
煨	OLGE
杈	SCYY
啐	KYWF
镧	QUGI
猢	QTDE
狲	QTBI
継	XONN
逯	VIPI
琊	GAHB
嘢	KJFB
傣	WDWI
姸	VFTF
晢	RRJF
嘁	KDHT
垨	FPFY
咻	KWSY
轾	LGCF
皴	CWTC
梶	SNTN
绗	XTFH
筏	TWAR
檫	SPWI
荳	AGKU
鹩	DUJG
関	UUDI
咭	KFKG
锷	QKKN
啫	KFTJ
莨	AYVE
冏	MWKD
飕	MQVC
鳜	QGDW
溇	IOVG
蓼	ANWE
翳	ATDN
鋐	QPDC
阊	UJJD
摅	RHAN
柟	SMFG
拶	RVQY
缑	XWND
劐	AWYJ
掊	RUKG
嗳	KEPC
蟏	JAVJ
蛸	JIEG
鸱	QAYG
鸮	KGNG
溎	ISFF
挲	IITR
舐	TDQA
蚩	BHGJ
殄	GQWE
垓	FYNW
絜	DHVI
峯	MTDH
菸	AYWU
蕃	ATOL
阆	UYVE
曈	JUJF
蚵	JSKG
鲉	QGMG
俦	WDTF
榀	SKKK
槎	SUDA
檩	SYLI
碲	DUPH
燚	OOOO
绉	XQVG
岫	MMG
颙	JMHM
慬	NAKG
剡	OOJH
炘	ORH
嵖	MSJG
岈	MAHT
榫	SWYF
猕	QTXI
镬	QAWC
穂	TGMN
峗	MQDB
疳	UAFD
詈	LYF
瞋	HFHW
倶	WHGW
粦	OQAH
戬	GOGA
褀	PUAW
艋	TEBL
蘖	AWNS
醴	SGMU
溲	IVHC
娈	YOVF
铙	QATQ
乜	NNV
鲑	QGFF
琲	GDJD
狍	QTQN
睚	HDFF
眦	HHXN
豋	WGKU
洹	IGJG
捩	RYND
蚺	JMFG
鲇	QGHK
阈	UAKG
珙	GAWY
蝮	JTJT
沔	IGHN
漖	IFTT
傩	WCWY
昴	JQTB
趿	KHEY
帻	MHGM
玡	GAHT
斫	DRH
扌	RGHG
暾	JYBT
嫘	VLXI
莼	AXGN
纮	XDCY
槊	UBTS
矞	CBTK
硎	DGAJ
掼	RXFM
鹮	LGKG
娦	VRGW
隌	BUJG
祂	PYBN
哔	KXXF
孛	FPBF
汩	IJG
莜	AWHT
対	YFY
跩	KHJX
癒	UWGN
鲠	QGGQ
傈	WSSY
僳	WSOY
圹	FYT
郫	RTFB
枌	SWVN
蟊	CBTJ
浠	IQDH
俵	WGEY
総	XWCN
喎	KMNK
蕈	ASJJ
碶	DDHD
鸻	TFHG
禤	PYLN
薮	AOVT
褝	PUIF
脔	YOMW
俤	WUXT
臾	VWI
矅	HNWY
蘼	AYSD
廸	MPD
堌	FLDG
黍	TWIU
貉	EETK
煿	OGEF
笥	TNGK
笮	TTHF
蚨	JFWY
奌	HKDU
昞	JGMW
獀	QTVC
辻	FPK
孥	VCBF
髙	YJFK
蝾	JAPS
螈	JDRI
笫	TTNT
増	FULJ
箪	TUJF
椐	SNDG
帏	MHFH
氶	BII
舢	TEMH
殭	GQGG
亖	FFF
郉	FTFB
苎	APGF
趷	KHTN
噃	KTOL
犭	QTE
揊	RGKL
斏	YYVE
裎	PUKG
敚	UKQT
撝	RETO
窋	PWBM
撊	RUEG
斊	YBF
鲣	QGJF
粼	OQAB
赓	YVWM
硪	DTRT
蛲	JATQ
岽	MAIU
蟛	JFKE
荢	APGF
竫	UQVH
珽	GTFP
皅	RCN
蚯	JRGG
蚓	JXHH
觐	AKGQ
峒	MMGK
轃	LDWT
颃	YMDM
仳	WXXN
録	QVIY
阗	UFHW
卲	VKBH
淯	IYCE
硷	DWGI
邳	GIGB
讃	YFWM
鑓	QKHP
唷	KYCE
绲	XJXX
噈	KYIN
砊	DYMN
棑	SDJD
刍	QVF
笳	TLKF
狺	QTYG
袆	PUFH
潴	IQTJ
蒌	AOVF
荩	ANYU
哞	KCRH
槁	SYMK
逖	QTOP
缧	XLXI
犞	TRTK
牰	TRMG
犂	TQTH
钫	QYN
犑	TRHD
犜	TRYT
睢	HWYG
獬	QTQH
豸	EER
彘	XGXX
绀	XAFG
氵	IYYG
毎	TXFJ
酽	SGGD
鹛	NHQG
郾	AJVB
龢	WGKT
巽	NNAW
鼩	VNUK
鼱	VNUE
锾	QEFC
衮	UCEU
薹	AFKF
廾	AGTH
嫠	FITV
扃	YNMK
巻	UDNB
恵	GMNU
藓	AQGD
沭	ISYY
砦	HXDF
硏	DFTF
鳏	QGLI
廪	YYLI
宍	PUU
痦	UGKD
蓊	AWCN
檠	AQKS
袢	PUUF
黾	KJNB
涙	IYND
撘	RTWK
闩	UGD
倢	WGVH
浡	IFPB
気	RNQU
鴞	KGNO
颞	BCCM
屛	NTFF
魈	RQCE
榞	SDRI
陹	BTAJ
尲	DNUO
炝	OWBN
鐄	QAMW
駀	CDNN
琙	GAKG
璾	GYVF
欬	YNTW
鰤	QOWH
庣	YIQV
觬	QEVQ
珦	GTMK
躩	KHHC
駸	CVPC
梷	HKCS
烄	OUQY
齗	HWWR
衵	PUJG
濗	IAJH
雘	MYAC
鲙	QGWC
綩	XPQB
粜	BMOU
襣	PUTJ
稸	TYXL
摽	RSFI
揘	RRGG
轞	LAHL
镆	QAJD
瀵	IOLW
酢	SGTF
鹢	UWLG
鍿	QGVL
豲	EDRI
籢	TWGT
埘	FJFY
呒	KFQN
徂	TEGG
鄗	YMKB
韹	UJRG
覥	MAWQ
蹀	KHAS
燍	OADR
銕	QGXW
豃	WWKT
艟	TEUF
椃	SHAM
庿	YALD
烵	OAQY
鱊	QOCK
騳	CCY
邒	SBH
醌	SGJX
稌	TWTY
湡	IJMY
烉	QMWO
壷	FPKG
檑	SFLG
鹚	UXXG
滆	IGKH
鶈	GVHO
蓠	AYBC
鐗	QUEG
蕼	ADVH
缗	XNAJ
譥	RYTY
鵊	DWWO
駣	CIQN
舡	TEAG
跲	KHWK
彐	VNGG
刳	DFNJ
黗	LFON
燌	OFAM
鲹	QGCE
幛	MHUJ
鷵	NFTO
魃	RQCC
鐊	QBJR
囯	LGD
篦	TTLX
僄	WSFI
烕	DGOT
苊	ADBB
菬	AIVK
魺	QOSK
鞆	AFGW
顂	SWWM
烗	OYNW
璯	GWGJ
烖	FAOI
澘	ISSJ
楙	SCBS
榬	SFKE
啁	KMFK
筇	TABJ
濓	IUTO
鋙	QGKG
磙	DUCE
瀡	IBDP
鯻	QOGJ
駧	CMGK
筽	TKGD
郤	WWKB
溞	ICYJ
钇	QNN
澬	IUQM
駪	CTFQ
疠	UDNV
鴺	GXWO
蝈	JLGY
惍	NQG
攮	RGKE
蹃	KHAK
縔	XCCS
痑	UQQI
鳺	FWWO
烐	OTEY
霪	FIEF
酫	SGWG
瀢	IKHP
妵	VYGG
钋	QHY
澫	IAJY
窷	PWBB
毲	CCCN
鵢	TMDO
髃	MEJY
齵	HWWY
觭	QEDK
韰	HQCG
蓂	APJU
謶	YYAO
掎	RDSK
醄	SGQM
譺	YXTH
鷏	FHWO
璂	GADF
倕	WTGF
鵮	QVWO
鸄	RYTO
鬙	DEUJ
塦	BLFF
翙	MQNG
凼	IBK
兯	UBJ
藴	AXJL
秲	TFFY
檂	SMAE
搷	RFHW
羾	NAG
巟	YNQB
潆	IAPI
駫	CIQN
旞	YTUP
擡	RFKF
憹	NMAE
鴁	TDWO
棬	SUDB
脀	BIGE
柊	STUY
裃	PUHH
麴	FWWO
蠘	JFAY
鳪	HWVO
秹	TWTF
梻	SWXJ
覼	GWMQ
匓	QVCC
頧	WNNM
篵	TTWH
芇	AMHJ
圙	LWDD
臡	AKFW
昋	TDJF
屲	TMJ
渇	IJQX
浲	ITDH
辪	HWNU
砙	DGNN
葙	ASHF
枿	SFAH
怛	NJGG
鮇	QOFI
莟	AWYK
磶	DVQO
鮊	QORG
岹	MVKG
潧	IULJ
黪	LFOE
暅	JNGG
硘	DLKG
橜	DUBS
箅	TLGJ
畾	LLLF
鹲	APGG
灛	IUKF
褷	PUTH
馞	TJFB
焪	OPWX
勈	CELN
踁	KHGA
暤	JRDF
劜	LNN
睤	HLGJ
帿	MHWD
鸍	GWMO
淗	IQOY
棛	SYCE
蜾	JJSY
鼄	RIMV
坅	FWYN
徯	TEXD
犫	WYYH
遌	KKFP
厎	DQAY
涽	IQAJ
蜑	THPJ
嬂	VUAJ
肒	EVYY
獹	QTHL
唈	KKCN
跈	KHWE
隟	BVJS
奯	DHDT
盚	FIYL
翇	NDCU
揗	RRFH
朲	SWY
麏	YNJK
睸	HNHG
橦	SUJF
蛝	JVEY
衃	TLGI
郲	SWWB
込	TYPI
脿	EGEY
弪	XCAG
赍	FWWM
絥	XWDY
扚	RQYY
娺	VCCC
憛	NSJH
聐	BFKG
硙	DMNN
廰	YBFN
鹞	ERMG
痀	UQKD
讐	WYWY
瓄	GFLM
辂	LTKG
韀	AFYO
搴	PFJR
轵	LKWY
黸	LFOL
蔩	APGW
跭	KHTH
雫	FGHU
癐	UWGJ
霙	FAMD
穰	TYKE
躴	TMDE
煔	OOHK
陑	BDMJ
孼	BTWB
逺	FNEP
輵	LJQN
胨	EAIY
瞆	HKHM
喛	KEFC
醹	SGFJ
訨	YHG
塮	FTMF
鈌	QNWY
潉	IMJX
欹	DSKW
竬	UTKY
刱	FJVW
镵	QQKY
岺	MWYC
隥	BWGU
傞	WUDA
瓆	GRRM
謭	YUEV
鱁	QOEP
蠈	MADJ
媂	VUPH
笵	TIBB
駥	CADT
渒	IRTF
灩	IDHL
羙	UGOU
弡	XANG
綐	XUKQ
粎	ONYY
菑	AVLF
嫀	VDWT
玴	GANN
螥	JWYK
矴	DSH
醿	SGYI
耤	DIAJ
槚	SSMY
嵣	MYVK
酾	SGGY
戝	MAT
嫰	VGKW
瑌	GDMD
铥	QTFC
閸	UGHG
椌	SPWA
齼	HWWH
嫽	VDUI
鯣	QOJR
蠝	JLLL
澷	IJLY
豽	EEMW
絣	XUAH
瓪	GNYC
轪	LDY
鈝	QRHH
聟	TDKB
茾	AGAJ
嬎	VQKG
溓	IUVO
琓	GPFQ
厑	DKXV
癛	UYLT
偣	WUJG
諡	YWGL
翂	NWVN
鲚	QGYJ
坄	FMCY
奓	DQQU
驆	CJAF
郍	TEBH
顐	PLDM
媅	VADN
岾	MHKG
襙	PUKS
瘗	UGUF
嘂	KKNK
椷	SDGT
黡	DDLO
漼	IMWY
噰	KYXY
鐭	QTMD
魗	FNAC
屧	NTAS
仢	WQYY
聥	BTKY
紖	XXHH
嗏	KAWS
鳾	GMHO
籯	TYNY
傗	WYXL
抣	RQUG
嬁	VWGU
霺	FTMT
橊	SGAL
巪	ANNB
倃	WTHK
軐	LNFH
椠	LRSU
鱆	QOUJ
坧	FDG
楇	SMNK
哹	KEBG
溭	ILWT
瓙	GFNO
烲	RROU
団	LFI
坆	FTY
埀	TGUF
绋	XXJH
椥	STDK
鴳	PVWO
禥	PYAF
渀	IDFA
慜	TXGN
黱	EUDO
殏	GQFY
鐛	QJYI
鑟	QFLM
鹨	NWEG
椣	SMAW
怫	NXJH
覔	GIHQ
扊	YNOO
轹	LQIY
砇	DYY
蔸	AQRQ
鼺	VNUL
垴	FYBH
趱	FHTM
梛	SVFB
鹾	HLQA
觌	FNUQ
鮆	HXQO
帋	QAMH
龗	FKKD
蠭	TDHJ
龤	WGKR
彟	VFAC
嶹	MFNF
莭	AVCB
楄	SYNA
鵽	CCCO
脞	EWWF
柉	STPY
砶	DRG
漃	IPHC
涋	IPDY
蟇	AJDJ
庋	YFCI
鮀	QOPX
啎	TFGK
谳	YFMD
鼘	FKUH
玊	GYI
趭	FHWO
懔	NYLI
硜	DGVA
繿	XAHL
櫷	STMG
婣	VTHH
譾	YUEN
鯹	QOJG
笚	TLJ
蟨	DUBJ
溚	IAWK
篜	TBIO
窞	PWQV
勄	TXGL
餕	WYVT
鄳	MGGB
痸	URMJ
貙	EEAK
槸	SFWY
堎	FFWT
樦	STYG
溔	IUGO
賱	MPLH
嬏	VTOL
鉊	QVKG
糷	OAUI
橾	SKKS
甝	HAMF
蕞	AJBC
癴	UXYR
鷎	RDFO
巓	MXHM
囜	LCI
瘅	UUJF
妠	VMWY
侘	WPTA
涁	ISET
爫	ETYT
聍	BPSH
呝	KYNN
鋫	TJQF
剫	YACJ
砹	DAQY
嵶	MXUU
肕	EVYY
牭	TRLG
郐	WFCB
憵	NKUN
摰	FWFR
錗	QTVG
宀	PYYN
黇	AMWK
糣	OAQJ
蘌	ATRI
鲌	QGRG
朰	SNB
噣	KLQJ
鎱	QFKE
苢	ANHN
鲗	QGMJ
硴	DAWX
澵	IUSR
叓	GKHC
甃	TOGN
辴	KKJE
匊	QOI
媿	VRQC
椶	SQBT
鵺	YWTO
莸	AQTN
觯	QEUF
墐	FAKG
艥	TEKT
揤	RVCB
汖	MIU
眔	LIU
慆	NEVG
鎌	QUVO
莰	AFQW
縢	EUDI
焩	OEEG
楛	SADG
娻	VGJI
蕛	ATUT
宬	PDNT
聣	BVQN
秴	TWGK
夓	VDHT
倎	WMAW
飔	MQLN
捝	RUKQ
肶	EXXN
翣	NUVF
髑	MELJ
趢	FHVI
铞	QKMH
粛	VOJK
蟱	JRLO
龠	WGKA
輽	LCDL
瘜	UTHN
眖	HKQN
鍨	QWGD
峅	MCAH
煯	OXXR
柺	SKLN
緿	XCKN
迕	TFPK
葝	AGVL
遚	VHCP
郻	HNVB
汌	IKH
疻	UKWI
杍	SBG
芿	AWEB
蝐	JJHG
杬	SFQN
齥	HWWX
悊	RRNU
鼮	VNUP
胼	EUAH
墛	FNFF
睟	HYWF
叇	FCVP
膒	EAKK
寘	PFHW
翽	HDGN
兺	WVKX
鱤	QODN
磌	DFHW
獂	QTDI
廕	YBWC
崺	MYTB
竨	UHJH
眿	HYNI
菨	AUVF
屭	NMMM
峧	MUQY
箎	THAM
儭	WUSQ
冘	PQV
栧	SJXT
剨	DHDJ
尵	DNKM
喩	KWGB
鼈	UMIV
豍	GKUF
痡	UGEY
煍	OTOY
畄	ILF
劚	NILJ
愢	NLNY
烞	OSHY
竈	PWFV
槡	SCCS
鄤	JLCB
嶐	MBTG
傋	WFJF
戻	YNDI
蛴	JYJH
呞	KNGK
巙	MUHT
耥	DIIK
耹	BWYN
慊	NUVO
墤	FKHM
瘚	UUBW
舑	TDMF
孞	BNU
崣	MTVF
僟	WXXT
癝	UYLI
羄	LXHJ
嬃	EDMV
痷	UDJN
鈃	QGAH
蘬	AWNH
焢	OPWA
塣	IKGF
埛	FMWK
糄	OYNA
虿	DNJU
罿	LUJF
懩	NUDE
聛	BRTF
苽	ARCY
锞	QJSY
蚔	JQAN
呧	KQAY
奺	VQYY
姯	VIQN
瘣	URQC
槞	SUJN
硾	DTGF
豙	UEU
孅	VWWG
葃	AJTF
舮	TEYN
瓁	GAWC
镟	QYTH
馪	TJPM
謞	YYMK
鄥	WVGB
壐	GWMF
刉	TNJH
鞻	AFKV
箶	TDEF
梐	SXXF
籴	TYOU
埓	FEFY
湇	IUEG
羗	UDNC
橅	SRLO
嬹	VWFW
毠	LKTN
隠	BEVN
淩	IFWT
畧	LTKF
朶	ESU
卩	BNH
柂	STBN
辠	THUJ
谫	YUEV
泬	IPWY
颴	MTJH
焬	OJQR
曪	JLXY
搣	RDGT
蹘	KHNE
鯺	QOFJ
徰	TGHH
擜	RFMD
価	WSG
弌	AGD
踰	KHWJ
糐	OGEF
鞁	AFHC
阃	ULSI
軁	TMDV
駋	CVKG
柈	SUFH
叧	KVB
鎛	QGEF
変	YOTU
櫂	SNWY
罒	LHNG
妺	VGSY
乕	RFMH
榥	SJIQ
嗺	KMWY
纝	XLLI
桞	SQBH
髁	MEJS
孧	XLBF
仚	WMJ
栭	SDMJ
忔	NTNN
鳢	QGMU
灋	IYNC
砬	DUG
椨	SYWF
硣	DFTB
匥	ACAK
撖	RNBT
漻	INWE
疷	UQAY
邔	NBH
贜	MADT
嵠	MEXD
鷢	DUBO
堞	FANS
脶	EKMW
魮	QOXX
鬕	DEAD
漡	ITJR
瞹	HEPT
磢	DDQQ
鑗	QTQI
邼	AGBH
媪	VJLG
紥	RNXI
髳	DECT
孄	VUGI
湕	IVFP
漌	IAKG
宧	PAHH
驣	CUDC
粧	OYFG
呣	KXGU
酜	SGFW
恏	VBNU
騻	CDQQ
唝	KAMY
悫	FPMN
誁	YUAH
裶	PUDD
鱜	QOXB
盝	VILF
鲮	QGFT
彣	YEE
湂	IKKN
纛	GXFI
鈈	QGIY
溰	IMGU
鉘	QXJH
肑	EQYY
洷	IGCF
鬋	DEUJ
榎	SDHT
熪	OTQQ
偝	WUXE
笷	TQTB
鯸	QOWD
盁	ELF
煖	OEFC
稤	TYIY
鍅	QIFC
縙	XABG
尀	AKFY
燀	OKKF
饛	WYVE
窾	PWFW
袼	PUTK
珵	GKGG
礭	DFWY
忮	NFCY
獕	QTMY
嘑	KHAH
鬘	DEJC
鮖	QODG
禕	PYNH
秮	TCKG
躈	KHRT
凷	FBK
闣	UIPL
竉	PWUD
欝	SQQF
悜	NKGG
鸘	FSHO
陫	BDJD
賿	MNWE
鍉	QJGH
畡	LYNW
鹐	QVQG
鷋	AWTO
萣	APGH
刓	FQJH
谸	TDWK
茀	AXJJ
黕	LFOQ
疉	LLLG
縦	XTUH
黣	LFOU
鶮	YMKO
嘄	KWVS
醻	SGFF
蝺	JTKY
覑	THGQ
揼	RDIY
颬	MTJT
膖	ETDP
桤	SMNN
骽	MEEV
畵	VFLB
涊	IVYN
钶	QSKG
楻	SRGG
姟	VYNW
刯	GJGJ
罏	RMHL
媡	VGLI
艔	TEYC
堈	FMUM
炇	OTY
撡	RCCN
畖	LRCY
圫	FTAN
筂	TIBB
唩	KTVG
歵	HGMY
譌	YETO
掔	AHNR
铻	QGKG
鈛	QAT
厠	DMJK
傃	WGXI
屫	NNHK
虤	HAMM
寚	PGRM
厈	DFK
沍	IGXG
臰	THGX
筨	TWYK
箜	TPWA
弫	XAHH
苉	AAQB
繛	GXIJ
刖	EJH
辔	XLXK
鱃	QOUF
鰇	QOCS
榉	SIWH
爦	OAHQ
蜊	JTJH
抟	RFNY
閺	UJYI
嗛	KUVO
爑	OAWO
荾	ACWT
鑂	QTGO
窽	PWXW
穏	TEVN
悡	TJNU
婼	VADK
寍	PNLF
箛	TBRY
舽	TETH
嘨	KVOJ
踷	KHFJ
袻	PUDJ
瀺	IQKY
鹓	PQBG
骩	MEVN
溮	IWNH
剒	AJJH
埅	BYFF
膬	ETFN
栤	SUIY
搛	RUVO
餭	WYVG
祧	PYIQ
劺	CRHL
啅	KHJH
錽	QGOT
藧	AXEC
矉	HPGM
颥	FDMM
羧	UDCT
聅	BTDY
竲	UULJ
耮	DIOL
帯	GKGH
皐	RIFJ
暚	JERM
晧	JTFK
騵	CDRI
婫	VJXX
徣	TAJG
蛍	IPJU
輰	LJGR
哘	KTFH
桒	FASU
嚾	KAKY
唍	KPFQ
縥	XDWT
鶄	GEWO
輨	LPNN
躷	TMDV
溬	IUDC
屵	MDR
嶚	MDUI
餫	WYVL
鋹	QDEY
哶	KGJF
髝	YMKL
呠	KSGG
綛	XVYN
嶭	MWNU
歮	HHHF
徭	TERM
疭	UWWI
浟	IWHT
橁	STQJ
菍	AWYN
婻	VFMF
蘴	ADHU
籷	OTAN
呡	KNAN
跰	KHUA
躮	TMDV
梼	SDTF
晐	JYNW
猨	QTEC
鬴	GKMY
牾	TRGK
葖	APWD
舻	TEHN
鉟	QGIG
搕	RFCL
叄	CCCD
弜	XXN
蘏	AXFM
刿	MQJH
訯	YEYY
郀	DFNB
齩	HWWQ
璼	GAHL
蘒	ATQV
鳤	QGTN
堍	FQKY
疦	UNWI
楜	SDEG
糪	NKUO
捠	RRGW
潈	ITLE
舘	WFKN
绦	XTSY
缣	XUVO
矈	HRPY
祳	PYDE
仛	WTAN
妅	VAG
餻	WYVO
亁	FJFN
蓨	AWHE
鄈	WGDB
伿	WKWY
僽	WTON
禓	PYJR
箊	TYWU
兦	TYNV
娗	VTFP
褖	PUXE
鎎	QRNO
髽	DEWF
唜	GSKX
蒪	AGEF
嵝	MOVG
桻	STDH
呩	KFIY
頼	GKIM
籒	TRGL
颾	MTJJ
揑	RVAG
蟔	JLFO
叅	CCCN
婜	AHNV
袑	PUVK
縖	XPDK
萙	ASPQ
蹗	KHYX
筈	TTDF
袘	PUTB
篞	TIJF
餗	WYVI
湈	IAFS
緀	XGVV
魬	QORC
溹	IFPI
灆	IAAL
蔧	ADHV
梙	SKKH
熍	OPKK
聤	BYPS
鵍	PFQO
籵	OFH
磈	DRQC
鸐	NWYO
焿	OYVW
藢	ATMT
壈	FYLT
肎	PEF
賍	MYFG
摬	RUJQ
儥	WFLM
陏	BDEG
蘃	AHHS
梎	SRXN
蚡	JWVN
盇	DYLF
兎	TKQY
杤	SDNN
縜	XKMY
裄	PUTH
毈	QYTC
襀	PUGM
摷	RVJS
瀤	IYLE
猑	QTJX
璊	GAMY
鶵	QBTO
矋	HDAY
桭	SDFE
唎	KTJH
摵	RDHT
彡	ETTT
箈	TICK
嫨	VAKW
濻	IBKM
壨	LLLF
袥	PUDG
匄	QYNV
鴴	TFHO
蝃	JCCC
鮘	QOWA
慭	GODN
翧	PGJN
愘	NPTK
苄	AYHU
妶	VYXY
麐	YNJK
萖	AVQB
哃	KMGK
媰	VQBT
麫	SWWN
踇	KHTU
鯄	QOFY
俖	WGIK
慩	NLPY
菞	ATQT
頛	DIDM
蠞	TVCJ
粐	OYNT
胐	EBMH
伇	WMCY
嚱	KHAA
齑	YDJJ
鐝	QDUW
歀	SFIW
鉧	QXGU
荎	AGCF
輁	LAWY
埝	FWYN
疺	UTPI
甪	TEK
駚	CMDY
鮃	QOGH
胉	ERG
凎	UQG
飶	WYVT
觜	HXQE
焐	OGKG
圂	LEI
櫖	SHAN
鲊	QGTF
夨	GNYI
捘	RCWT
譀	YNBT
墦	FTOL
佽	WUQW
覙	QIHQ
雝	VKCY
澋	IJYI
鏱	QUJH
藦	AYSR
嗃	KYMK
鎤	QJIQ
陉	BCAG
衳	PUWC
匇	QQI
羘	EUDH
蜋	JYVE
罥	LKEF
挗	RGXW
遰	AQPP
撏	RVAF
闂	UUDB
滀	IYXL
寀	PESU
嬦	VFNF
汍	IVYY
笐	TYMB
缫	XVJS
楍	SKKK
斾	YTMH
樶	SJBC
倠	WWYG
翗	QQNG
窳	PWRY
膫	EDUI
竻	TLB
悞	NKND
圿	FWJH
魼	QOFC
鹪	WYOG
棓	SUKG
缞	XYKE
尰	DNTF
嗧	LKWA
扏	RVN
尜	IDIU
卭	ABH
鳲	NWVO
潀	ILWY
吣	KNY
呬	KLG
賋	MUQY
堔	FPWS
汣	IQYY
儣	WYAW
駊	CHCY
蠇	JAJY
紭	XXCY
幆	MHJN
咡	KBG
苝	AUXB
崊	MSSY
紤	XRH
锪	QQRN
夗	QBN
覀	SGHG
夛	VQU
瞣	HKKN
猆	DJDD
塥	FGKH
諝	YNHE
媀	VJMY
橗	SAJE
冚	PMJ
屳	TYMJ
歃	TFVW
酛	SGFQ
轑	LDUI
綟	XYND
垎	FTKG
鉫	QLKG
晲	JVQN
忯	NQAN
銝	QWSY
蝵	TOJU
闧	UFKP
酕	SGTN
邖	MBH
賥	MYWF
鱏	QOSJ
驓	CULJ
躸	TMDK
踤	KHYF
虊	AXYS
盋	DCLF
壼	FPGG
娏	VDNE
顄	BIBM
鹒	YVWG
轀	LLWL
娧	VUKQ
咃	KWBN
猁	QTTJ
晬	JYWF
髣	DEYB
塸	FAKK
肊	ENN
妡	VRH
巊	MMMV
倧	WPFI
陠	BGEY
蘈	ATMM
棦	SQVH
徦	TNHC
艹	AGHH
麄	WVYX
縡	XPUH
礏	DOGW
羃	LAJH
暣	JRNO
詉	YVCY
燤	OAJY
芧	ACBJ
鈨	QFQN
刣	CKJH
佶	WFKG
馚	TJWV
犤	TRLX
衿	PUWN
唒	KSGG
纐	XUQM
屴	MLB
椊	SYWF
狎	QTLH
馃	QNJS
揂	RUSG
湦	IJTG
荖	AFTX
嫍	VEVG
橛	SDUW
伃	WCBH
濐	IJFJ
懥	NFPH
蜅	JGEY
诼	YEYY
璪	GKKS
穉	TNIH
叞	NFIC
谼	WWKW
梩	SJFG
歛	WGKW
侅	WYNW
皨	RRRF
嬇	VKHM
婖	VGDN
锬	QOOY
濌	TGJJ
愝	NAJV
坥	FEGG
鱳	QOXS
藣	ALCX
圱	TDFG
钲	QGHG
茘	AVVV
黮	LFON
鼥	VNUC
実	PDWU
壖	FFDJ
埏	FTHP
鳰	TYWO
狤	QTFK
滏	IWQU
宭	PVTK
唞	KRUF
徃	TTGG
墪	YBTF
婋	VHAM
禼	HLQC
蒥	AQYL
羢	UDAD
橒	SFFC
夦	ADWQ
鑶	QADT
鏾	QAET
詪	YVEY
赬	FOHM
誮	YAWX
扙	RDYY
嚽	KGQM
絊	XSGG
瓋	GUMP
蔴	AYSS
鲰	QGBC
燓	SQQO
麅	YNJN
鷟	YTTO
嘏	DNHC
亄	FPGN
肷	EQWY
搻	WGKR
鐱	QWGW
毃	YMKC
颸	MTJN
罳	LLNU
踆	KHCT
羴	UDUD
珤	GRMH
襃	YQGE
輤	LGEG
嚔	KFPH
閲	UUKQ
橚	SVHH
泏	IBMH
瓡	FUFY
碽	DAMY
穱	TELF
虅	AEUC
錉	QQAJ
瑒	GJGR
虲	JHY
薭	ATRF
胣	ETBN
豩	EEY
妷	VRWY
鳋	QGCJ
銿	QCEH
烻	OTHP
耚	DIHC
迮	THFP
莁	AAWW
崥	MRTF
襈	PUNW
炪	OBMH
乲	UQWN
稯	TQBT
櫢	SKGT
栳	SFTX
斮	AJRH
礲	DUED
窐	PWFF
蚏	JEG
粏	ODYY
鑆	QOGF
榝	SQSC
胔	HXMW
郙	GEHB
鶃	WVGQ
窫	PWDD
灡	IAUI
臦	NHAH
爠	OHHY
聫	BXXD
熭	DHDO
唣	KRAN
浶	IPRH
熦	OIWY
喡	KNHH
缍	XTGF
﨣	FHUF
腽	EJLG
纼	XXHH
骍	CUH
葘	AGVL
塰	ITXF
轠	LLLL
囋	KTFM
簲	TERF
仯	WITT
曱	JHK
鞶	TEMF
谻	WWKT
畓	ILF
蟟	JDUI
誳	YNBM
繙	XTOL
龡	WGKW
氡	RNTU
蠉	JLGE
颏	YNTM
螚	CEXJ
鰰	QOPH
甛	AFTD
鲾	QGGL
蟧	JOOL
紽	XPXN
邭	QKBH
蚠	WVJU
鷆	XHNO
褵	PUYC
裚	RRYE
盩	FUFL
婔	VDJD
艃	TEJF
嶪	MOGW
攲	DSKC
訿	YHXN
曣	JAUO
氝	RNMW
劋	KKKJ
玜	GWCY
圯	FNN
鎥	WHTQ
鼊	NKUV
溻	IJNG
咥	KGCF
稂	TYVE
濶	IUTD
梋	SKEG
镞	QYTD
簔	TYGE
掱	RRRJ
栘	SQQY
噞	KWGW
攵	TTGY
嵤	OOPM
隹	WYG
鐧	QUJG
缯	XULJ
殦	GQWO
緼	XJLG
狖	QTPW
箬	TADK
坬	FRCY
褉	PUDD
礓	DGLG
颻	ERMJ
丠	UXGF
茩	ARGK
愳	HHNU
魻	QOLH
曔	JAQT
戠	UAJD
膷	EXTB
哙	KWFC
搇	RWYE
峔	MFTX
釼	QVYY
觃	MQBD
堓	FMDF
垧	FTMK
禗	PYLN
疎	NHGI
汏	IDY
羣	VTKD
拰	RWTF
喞	KRXB
簛	TADR
佖	WNTT
瓨	AGNN
眪	HGMW
埾	BCFF
瀿	ITXI
榼	SFCL
铽	QANY
踕	KHGH
篻	TSFI
敻	QMWT
嗥	KRDF
堻	IVFF
箮	TPGG
滰	IUJQ
騯	CUPY
覫	UPYQ
倨	WNDG
縓	XDRI
笉	TQUF
爗	OJAF
笁	TAF
騲	CAJH
坘	FGXG
醆	SGAA
熈	TAHO
槼	FWHS
犈	TRUB
圲	FTFH
儴	WYKE
鷷	USGO
躣	KHHY
搈	RPWK
亗	MFF
羜	UDPS
疈	GKLL
珇	GEGG
涶	ITGF
賮	VHGM
佱	WFHF
崵	MJGR
銺	NHDQ
髰	DEAN
綝	XSSY
糬	OLFJ
孋	VGMX
犗	TRPK
乶	GEHN
滊	IRNO
哿	LKSK
艎	TERG
莑	ATDH
巘	MHAD
鄮	QYVB
泙	IGUH
癈	UWXC
胻	ETFH
窭	PWOV
鑜	QIPM
纎	XFAG
饹	QNTK
腄	ETGF
踑	KHAW
赕	MOOY
膄	EVHC
膔	EYNX
肰	EDY
鵐	AWWO
燯	OFWC
闝	UMTI
禯	PYME
甼	LSJ
笅	TQQU
鑁	QQOT
萾	AECL
擕	RWYM
橃	SWXC
礒	DUGT
襅	PUJF
蘕	AXTP
穻	PWGF
鵞	TRNO
箃	TBCU
黩	LFOD
醠	SGML
禢	PYJN
襩	PUFM
錿	QHAM
顝	MEDM
觏	FJGQ
湺	IWKS
鉜	QWFY
湲	IEFC
筿	TTSU
蚟	JGG
獡	QTVO
鶣	YNMO
挳	RGVA
澖	IUSY
煀	ONBM
蒡	AUPY
鹷	HLQC
舤	TEMY
笟	TRCY
蹓	KHQL
檹	SYTK
骃	CLDY
忥	RNNU
藭	APWX
椟	SFND
刾	GUWJ
欈	SMWK
碆	IHCD
顟	NWEM
蛠	JLLL
褜	EQNE
膴	ERLO
魙	ILRC
糥	ODMJ
闒	UJND
圽	FQRT
鐑	QXFK
壪	FXYX
蕹	AYXY
鶊	YVWO
焝	OQAJ
炧	OTBN
洃	IDOY
挩	RWKQ
墠	FKKF
洑	IWDY
瀭	ILWJ
垑	FQQY
抪	RDMH
媠	VDAE
湚	ITXN
赲	FHLV
鰙	QOAK
囓	KDHB
謌	YSKK
鄓	THDB
笯	TVCU
翨	NJGH
肦	EWVN
艡	TEIL
砋	DHG
挦	RVFY
涜	IFPQ
頪	ODMY
顤	FFFM
爖	OUED
纥	XTNN
鍩	QADK
繍	XVOJ
熅	OLWL
﨩	BWVM
蔹	AWGT
缟	XYMK
莦	AIEF
碇	DPGH
礉	DRYT
銍	QGCF
蹹	KHWN
竘	UQKG
遪	CCCP
橷	SURQ
翈	LNG
薢	AQEH
榤	SQAS
焋	NHDO
鄫	ULJB
蘀	ARLF
岻	MQAY
疰	UYGD
嫜	VUJH
劶	RGKL
蟝	JIAS
銵	QTMT
竱	UGJF
酂	TFQB
饂	WYVL
伆	WQRT
宂	PMB
昺	JGMW
畩	LYEY
譍	YWWY
卽	RXBH
揳	RDHD
譤	YRYT
尫	GQGD
鳔	QGSI
鮷	QOUT
齄	THLG
痌	UMGK
隣	BOQH
祹	PYQM
垥	FWGK
幒	MHTN
啴	KUJF
攱	UFCY
茚	AQGB
磀	DUBP
蟙	JUAJ
毝	TFNE
龎	DUED
籶	OMN
骫	MEVY
嵛	MWGJ
梄	SSGG
芅	AAU
饙	WYVM
抁	RCQN
瞶	HKHM
釴	QAY
硰	IITD
笹	TANB
曏	JXTB
瑥	GJLG
褎	YQGE
畂	LQYY
偄	WDMD
衒	TYXH
彽	TQAY
倂	WTFF
殐	GQGI
宼	PFQV
垰	FHGH
莛	ATFP
揞	RUJG
礰	DDTH
縗	XYKE
矁	HTON
頙	GHDM
鸏	APGO
揫	TORJ
竾	TBB
顒	JMHM
傆	WDRI
飗	MQQL
猲	QTJN
杴	SQWY
頱	EFDM
鏶	QWYS
憙	FKUN
瀩	ITMM
坕	RHYF
姼	VQQY
茓	APWU
呿	KFCY
睃	HCWT
亷	UTVO
鷀	UXXO
侳	WWWF
筥	TKKF
琞	JEGY
赱	FUYU
螠	JUWL
畹	LPQB
盦	WYNL
鰯	QOXU
繴	NKUI
膈	EGKH
驐	CYBT
肗	EVG
蹖	KHDV
俙	WQDH
蛌	JRCY
傛	WPWK
戵	HHWA
枈	XXSU
迉	NPE
獩	QTHT
穪	TGWQ
鵥	UDJO
鸊	NKUO
澶	IYLG
畷	LCCC
磤	DRVC
寽	EFU
犽	QTAT
贀	ATDM
跞	KHQI
鎼	QHAR
竷	UJTT
乭	DNB
髫	DEVK
枦	SYNT
踄	KHHI
雟	BTWK
樐	SHLO
桫	SIIT
鱇	QOYI
撙	RUSF
痩	UJHC
鮙	QONG
澢	IIPL
侕	WDMJ
籏	TYTW
颫	MTJW
鲿	QGIC
簐	TLQW
簊	TADF
钃	QNIJ
弉	NHDA
甿	LYNN
艨	TEAE
斛	QEUF
跧	KHWG
貭	RFMI
璑	GRLO
郣	FPBB
羀	MQQL
皶	SJGC
邾	RIBH
鷕	KWYO
藖	AAHM
攃	RAWI
螖	JMEG
篺	TRRF
矧	TDXH
仼	WGG
隳	BDAN
顖	TLQM
堚	FPLH
磸	DUSD
砅	DIY
桰	SQAK
蔲	APFT
錾	LRQF
緌	XTVG
硻	AHND
彏	XHHC
腖	EGJI
宖	PXCU
馧	TJJL
慿	UGHN
訩	YQBH
庺	YWCS
翍	NHCY
鑞	QVLN
吥	KGIY
窓	PWCN
薻	AIVS
渮	IASK
揇	RFMF
瞤	HUGG
厊	DAHT
垊	FNAN
祲	PYVC
廌	YNJO
矱	TDAC
冴	UAHT
愸	SWWN
苐	AXHT
卼	GQQB
柝	SRYY
畠	RLF
晠	JDNT
洚	ITAH
悰	NPFI
蕋	AHHH
垿	FYCB
羕	UGYI
躵	TMDN
梾	SGOY
梚	SQKQ
縆	XNGG
麆	YNJG
鋣	QAHB
駦	UDCU
痎	UYNW
緔	XIMK
闶	UYMV
繘	XCBK
饧	QNNR
潣	IUYY
壋	FIPL
妐	VWCY
硛	DYOY
犵	QTTN
磞	DMEE
鯟	QOGI
奡	DHDJ
烠	ODEG
粚	OTBN
烮	GQJO
騚	CUEJ
踓	KHWY
罫	LFFH
咺	KGJG
姴	GQJV
蒣	ATWT
絝	XDFN
胅	ERWY
涫	IPNN
毣	NTFN
勎	FWFL
垯	FDPY
鋠	QDFE
钍	QFG
脬	EEBG
樒	SPNM
媷	VDFF
缐	XRIY
陻	BSFG
鎶	QSKK
餠	WYVF
鰶	QOWI
枠	SVFH
魱	QOGG
殨	GQKM
鎐	QERM
壔	FFNF
繣	XVFG
饾	QNGU
夼	DKJ
鞄	AFQN
嵁	MADN
靻	AFEG
桯	SKGG
汚	IFNN
辺	VPV
竩	UPEG
澸	IDGN
畗	YLF
舳	TEMG
埉	FDWW
戅	UJAN
掿	RADK
湀	IWGD
蛕	JDEG
喸	GEHX
鄽	YJFB
鼝	ITHC
夔	UHTT
旾	GBNJ
蕅	AIJY
仾	WGXG
鑪	QHAL
鹁	FPBG
烀	OTUH
偛	WTFV
薴	APNS
拀	RKQN
懎	NFWK
鯂	QOSG
汥	IFCY
蒉	AKHM
棢	SMUN
垉	FQNN
膥	GSDW
掁	RDEY
鴒	WYCO
譮	YWGJ
竪	AHNU
艶	MAGC
耔	DIBG
祏	PYDG
蓗	ATFH
稑	TFWF
輑	LVTK
袔	PUSK
恟	NQQB
怰	NYXY
壻	FNHE
睎	HQDH
埖	FAWX
鮂	QOLW
臎	ENYF
釮	QFTT
蝝	JXEY
唫	KQG
暶	JYTH
鉕	QAKG
鲯	QGAW
惓	NUDB
翺	THIN
稥	TOJF
偁	WEMF
罱	LFMF
懠	NYVF
礚	DAFL
齓	HWWN
榋	SVVV
餥	DJDE
煭	VGQO
戋	GGGT
鴱	AQWO
妏	VYY
缏	XWGQ
勌	UDBL
檘	SNKU
菎	AJXX
筮	TAWW
獦	QTAN
粔	OANG
诎	YBMH
灻	FOU
饫	QNTD
嬞	VATF
鼏	PHNN
瞨	HOGY
悾	NPWA
魩	QOQR
臑	EFDJ
糺	XNN
瑸	GPRW
荺	AFQU
怺	NYNI
諻	YRGG
纉	XFWM
藆	APFR
綥	XLGJ
犩	TVRH
藟	ALLL
翉	SGNG
瓾	TVGN
垁	FTDY
勔	DMJL
祤	PYNG
漑	IRXQ
穚	TTDK
瞁	HHDY
騡	CRIY
镡	QSJH
膰	ETOL
颭	MTJK
啒	KNBM
虀	AYVG
嶬	MUGT
顃	OODM
钑	QEYY
渉	IHIT
枓	SUFH
鮹	QOIE
睷	HVFP
爼	QQEG
禨	PYXT
爢	YSSO
譿	YDHN
捛	RKKG
櫰	SYLE
溋	IECL
銗	QRGK
耵	BSH
獜	QTOH
蜙	JSWC
饆	WYVF
乺	RNRN
粍	OTFN
臗	EPAY
攩	RIPO
郕	DNNB
揨	RYPS
蝆	JGKF
珷	GGAH
凣	HMV
珨	GWGK
罊	LBMM
熯	OAKW
绂	XDCY
嬠	VKKS
鄹	BCTB
閴	UMI
崓	MLDG
钸	QDMH
蠗	JNWY
肼	EFJH
猅	QTDD
桲	SFPB
薝	AQDY
樈	SUJQ
禵	PYJM
郎	YVEB
麜	YNJS
彵	TBN
鞼	AFKM
晡	JGEY
趡	FHWY
蹐	KHIE
踾	KHGL
欘	SNIJ
譢	YUEP
鋂	QTXU
剺	FITV
垙	FIQN
輬	LYIY
冱	UGXG
酏	SGBN
欪	BMQW
峍	MVFH
砏	DWVN
纩	XYT
撄	RMMV
遾	TAWP
絫	CCCI
堉	FYCE
訷	YJHH
帓	MHGS
镲	QPWI
鰃	QOLE
殛	GQBG
籙	TQVI
茔	APFF
闏	UMTJ
笖	TNYW
歞	JXXW
闠	UKHM
燠	OTMD
踨	KHWH
呭	KANN
匩	ABHG
錪	QMAW
羶	UDYG
藬	ABKM
鸺	WSQG
倱	WJXX
穊	TVCQ
畮	LTXU
槱	SSGO
槖	FPDS
鋲	QRGW
鳼	YWVO
苮	AWMJ
颰	MTJC
鏼	QTGI
儞	WGWQ
泝	IRYY
嬀	VETO
爩	OSRE
矙	HUNT
阩	BTAH
柛	SJHH
忲	NDYY
従	TUHY
擨	RRHW
揦	RGKJ
塱	YVCF
衜	TUTH
寠	PKGV
蹾	KHYT
牋	THGA
璢	GGAL
謷	GQTY
踠	KHPB
璏	GXGX
汫	IFJH
斉	YJFF
餇	WYVK
蹏	KHRM
鍎	QRFH
薫	ATGO
蕧	ATTT
寷	PDHU
鍚	QJGR
膌	EIWE
茦	AGMI
趐	FHND
溵	IRVC
眆	HYN
愞	NDMD
蕫	AUJF
雺	FCBT
仮	WRCY
塴	FMEE
旡	AQV
嚊	KTHJ
蜮	JAKG
梑	SQTO
恌	NIQN
櫔	SDAY
蕑	AUEF
瀙	IUSQ
筄	TIQB
籂	TWYH
丆	DGT
舝	NHVH
浫	IPWF
憻	NYLG
揵	RVFP
沞	IGMH
镠	QNWE
臜	ETFM
茳	AIAF
煗	ODMD
鞧	AFUG
熷	OULJ
輄	LIQN
圊	LGED
穇	TCCE
绤	XWWK
塈	VCAF
閁	UTE
抰	RMDY
珚	GLDY
黭	LFOA
鈅	QEG
砿	DYCY
搹	RGKH
鮉	QOVK
紘	XDCY
驵	CEGG
撹	RIPQ
妌	VFJH
鮛	QOHI
鑮	QAIF
蓍	AFTJ
餯	WYVE
窔	PWUQ
漝	INRG
銆	QDJG
鎁	QBBH
榩	SHAY
玤	GDHH
炢	OSYY
鈚	QXXN
旴	JGFH
芑	ANB
奞	DWYF
僠	WTOL
袬	YCKE
坶	FXGU
絔	XDJG
髭	DEHX
苩	ARF
阌	UEPC
黻	OGUC
鎇	QNHG
繌	XTLT
鶾	FJWO
葾	AQBN
滙	IAWY
幖	MHSI
猵	QTYA
鴸	RIWO
賷	FKKM
姱	VDFN
謪	YUMK
鲺	QGNJ
怼	CFNU
鯚	QOTB
痬	UJQR
弾	XIJF
冝	PEGF
胙	ETHF
趑	FHUW
眣	HRWY
狟	QTGG
侸	WGKU
矔	HAKY
睕	HPQB
泜	IQAY
赿	FHQA
灇	IOGC
醤	UEFG
粂	QYOU
磇	DTLX
翮	GKMN
凥	NMV
鱞	QOLE
腣	EUPH
鍏	QNHH
茮	AHIU
椚	SUG
戂	NYSD
嫃	VFHW
閜	USKD
兓	AQAQ
徤	TVFP
圠	FNN
旿	JTFH
嫊	VGXI
驋	CWXC
嗭	FHKX
勠	NWEL
悒	NKCN
吔	KBN
諪	YYPS
冓	FJGF
洓	IGMI
湬	TOIU
贒	AHNM
鸹	TDQG
銱	QKMH
腉	EVQN
迠	HKPD
謆	YYNN
礽	PYEN
珋	GQTB
鱂	QONF
鶟	PWDO
璝	GKHM
壴	FKUF
偢	WTOY
璡	GWYP
譵	YOGF
鐈	QTDK
浰	ITJH
蔾	ATQS
埒	FEFY
脻	EGVH
馹	CJG
鞬	AFVP
鶡	JQWO
薼	AYNF
彉	XAMW
跅	KHRY
濍	IAQN
蓸	AGMJ
蚰	JMG
氊	TFNG
囒	KAUI
鐌	QQJE
矺	DTAN
鍗	QUPH
荗	ADYT
鋿	QIMK
鮅	QONT
摉	RPWQ
撧	RXQC
襂	PUCE
鈜	QDCY
獘	UMID
叕	CCCC
撶	RAGF
桄	SIQN
勮	HAEL
剦	DJNJ
欫	RHQW
厞	DDJD
傦	WMEG
堜	FGLI
噭	KRYT
摦	RDFY
躘	KHUD
﨎	HGQC
敱	MGKC
耯	DIAC
坈	FPMN
毴	TFND
綍	XFPB
釚	QVN
颣	OXIM
艐	TEQT
紃	XKH
垘	FWDY
馘	UTHG
籆	TAWC
煚	JANO
傒	WEXD
捔	RQEH
胵	EGCF
杽	SRH
痓	UGCF
稬	TDMD
兏	DHQV
冂	MHN
脠	ETHP
慽	NDHT
僣	WFWJ
絗	XLKG
蒮	APWY
鑱	QQKY
潥	ISOY
榱	SYKE
摚	RIPF
趠	FHHJ
薸	AISI
陾	BDMD
跱	KHFF
楏	SDFF
譳	YFDJ
蹡	KHNF
拁	RLKG
蝟	JLEG
侒	WPVG
彂	OGXD
窚	PWDT
揿	RQQW
铹	QAPL
眹	HUDY
阥	BIY
塕	FWCN
捓	RAHB
僢	WEPH
煝	ONHG
詤	YWNQ
椬	SPEG
榙	SAWK
糮	OAHL
卋	FAF
唅	KWYK
瓲	GNYN
鞞	AFRF
誏	YYVE
絼	XEET
皷	FKUC
閠	UGYI
渄	IDJD
蚻	SNJU
槩	RXAS
訽	YQKG
甮	QREJ
锫	QUKG
禑	PYJY
妁	VQYY
聇	BGHG
庮	YSGD
繵	XYLG
釠	QMN
嘌	KSFI
熽	OVHH
崯	MQG
伄	WXHH
踲	KHRH
魐	RQCO
犿	QTYH
鍑	QTJT
燘	OUYY
簚	TLAH
铇	QQNN
縎	XMEG
柇	STY
朠	EAMD
抝	RXNN
塡	FXHW
帱	MHDF
慸	AQPN
澌	IADR
彑	XGD
勀	DQLN
鈒	QEYY
瑏	GPWT
晆	JFFG
隓	BDAA
鍕	QPLH
筼	TKMU
璤	GGJN
弿	PFJX
朞	ADWE
碞	KKKD
肜	EET
郖	GKUB
褴	PUJL
埚	FKMW
祄	PYWJ
抦	RGMW
怋	NNAN
塆	FYOX
譹	YYPE
銞	QJQF
蓔	AUGO
琧	GHGY
灺	OBN
屰	UBTR
礶	DAKY
縤	XGXI
齱	HWWC
鏅	QWHE
搌	RNAE
膆	EGXI
豞	EQKG
轈	LVJS
痭	UEED
齫	HWWS
伀	WWCY
徍	TFFG
噽	FKUG
乵	UNN
攭	RXEJ
竸	UJQQ
憜	NBDE
駹	CDNE
斺	YWJH
馤	TJJN
滮	IHAE
脝	EYBH
悳	FHNN
菻	ASSU
檗	NKUS
虓	VHAM
瞱	HAGF
汒	IYNN
膱	EUAJ
埢	FUDB
熂	ORNO
鏭	QTON
羝	UDQY
礼	FINN
鏉	QGKW
冞	POU
搠	RUBE
魾	QOGG
駌	QBCU
諁	YCCC
齛	HWWN
硍	DVEY
愲	NMEG
啙	HXKK
凘	UADR
暒	JJTG
窡	PWCC
蕒	ALMU
靯	AFFG
薉	AHDT
聧	BWGD
懭	NYAW
乷	IITN
睉	HWWF
穦	TPGM
顨	DMDJ
頢	TDDM
刧	FCVN
躤	KHAJ
炞	OYHY
懮	NDET
婘	VUDB
觇	HKMQ
杺	SNY
绖	XGCF
婏	VQKY
垍	FTHG
嶷	MXTH
遻	KKUP
璥	GAQT
铔	QGOG
騕	CSVG
殬	GQLF
稶	TAKE
黤	LFON
犋	TRHW
劗	TFQJ
焣	BCOU
亯	YJF
欎	SQQF
櫊	SUTK
柨	SDMH
焲	OYWY
藈	AHWD
讻	YQBH
譱	UDYY
丬	UYGH
岙	TDMJ
汘	ITFH
嬳	VAWC
貮	GAMI
椇	SHWY
祦	PYKD
桚	SVQY
砩	DXJH
垪	FUAH
拲	AWRJ
耪	DIUY
玁	QTKT
覭	PJUQ
焾	OWYN
爥	ONIJ
娒	VTXU
旪	JFH
馠	TJWK
艠	TEWU
瑑	GXEY
鷛	YVEO
椪	SUOG
伩	WYY
嶔	MQQW
蝏	JYPS
虪	HAMO
僶	WMGV
倓	WOOY
繊	XFAG
鄦	RLGB
欛	SFAE
鰺	QOCE
椙	SJJG
賩	MPFI
衏	TFQH
竏	UTFH
篢	TAMU
虍	HAV
燫	OYUO
蒃	AXEU
蔕	AAQH
爙	OYKE
奛	DJEF
扵	RWUY
徫	TNHH
洠	ICRH
釖	QVN
垆	FHNT
聓	AMYB
洣	IOY
翝	PDCN
偨	WHXS
劷	UDLN
裓	PUAA
醙	SGVC
澼	INKU
酴	SGWT
敪	CCCT
塽	FDQQ
勍	YILN
灉	IVKY
瘂	UGHG
鴀	GIWO
惃	NJXX
祒	PYVK
澻	IUEP
榧	SADD
翄	NFCY
徖	TPFI
澦	ICBM
濋	ISSH
冎	MNMB
檥	SUGT
铴	QINR
鳁	QGJL
覵	UEHQ
竌	UMN
蝼	JOVG
桍	SDFN
瓃	GLLL
憝	YBTN
齽	HWWI
秱	TMGK
笿	TTKF
餂	WYVD
潳	INFJ
妦	VDHH
嶉	MKWY
鄃	WGEB
骒	CJSY
匑	QTMX
舙	TDTD
婝	VPGH
灱	OVN
硳	DFOY
彜	XGOA
娐	VEBG
廘	YYNX
婅	VQOY
螣	EUDJ
獥	QTRT
搳	RPDK
茻	BTBH
槤	SLPY
壄	SCBF
婌	VHIC
漎	ITWH
蟫	JSJH
姖	VANG
陙	BDFE
墺	FTMD
醘	SGFL
瀸	IWWG
鰪	QOFL
艕	TEUY
鉲	QHHY
缼	RMQW
汳	IRCY
瓐	GHAL
牨	TRYM
銴	RRQF
樴	SUAJ
杮	SGMH
揝	RTHJ
軽	LCFG
螉	JWCN
丄	HGD
穽	PWFJ
嬊	AUKV
甂	YNMN
雔	WYWY
蕌	AJJJ
硄	DIQN
紴	XHCY
屻	MVYY
媇	VUSY
啀	KDFF
凔	UWYK
坒	XXFF
碦	DPTK
姉	VGMH
聺	BPWI
涾	IIJG
沵	IQIY
娞	VEVG
鱄	QOGF
氎	LLLN
牮	WARH
杻	SNFG
腬	ECBS
砫	DYGG
滻	IUTG
胗	EWET
転	LFCY
悃	NLSY
陔	BYNW
烅	OTLG
钘	QGAH
跹	KHTP
凵	BNH
丼	FJYI
釒	QTYG
琄	GKEG
寜	PNLH
箉	TRKL
仺	WAGF
擸	RVLN
崆	MPWA
赇	MFIY
唶	KAJG
靧	DMJM
拵	RDHB
膐	YTEW
忂	THHY
黺	OGUV
鉪	QANN
撎	RFPU
矒	HALH
竝	UUG
拏	VCRJ
応	YNI
奷	VTFH
耡	DIEL
圝	LXYX
瘹	UQQY
苻	AWFU
帇	VMHK
杪	SITT
銏	QMMG
鮢	QORI
懗	NFOO
欳	HMAW
祵	PYLS
棸	BCSU
籑	THDE
迀	FPK
靾	AFAN
挜	RGOG
鶕	UJWO
菋	AKFI
僘	WIMT
麔	YNJK
祜	PYDG
垸	FPFQ
僛	WADW
穨	TMKM
擙	RTMD
潹	ISSS
絤	XSG
梞	SNNY
槠	SYFJ
擩	RFDJ
嫴	VDUH
柗	SWKG
鐟	QFWJ
躗	TNHH
翶	RIFN
榠	SPJU
瘕	UNHC
婃	VPFI
罼	LJAF
娰	VWNW
欶	GKIW
拤	RHHY
朖	EYVE
嚈	KDJD
謉	YRQC
溳	IKMY
嬫	VOOS
浥	IKCN
敳	MGKT
洆	IBIG
淎	IDWH
肣	EWYN
箚	TWGJ
踎	KHGK
擑	RKBT
蓴	AGJF
鉮	QJHH
挰	RKGG
匔	QTMK
瓑	GDTH
殗	GQDN
凧	MMHK
覂	STPU
啯	KLGY
鈶	QCKG
歄	MNMW
鈢	QSY
鍢	QGKL
黂	YSSM
崐	MJXX
嬻	VFLM
鵇	RHFO
餣	WYVN
浻	IMWK
笾	TLPU
孊	VYSD
愐	NDMD
揯	RNGG
繗	XOQH
炑	OSY
擛	RAAS
咊	KTY
魡	QOQY
捹	RDFA
燣	OYLT
旝	YTWJ
蠺	GDGJ
膲	EWYO
腟	EPGF
苪	AGMW
沷	IDCY
熡	OKGV
櫗	SALT
媃	VCBS
嗋	KLLE
櫐	LLLS
螬	JGMJ
裞	PUUQ
腷	EGKL
菦	ARPU
稃	TEBG
喿	KKKS
庰	YUAK
惗	NWYN
鬾	RQCC
竡	UDJG
恑	NQDB
掾	RXEY
昻	JABJ
戙	MGKA
祍	PYTF
綖	XTHP
亸	YBUF
鰢	QOCY
阧	BUFH
炶	OHKG
齌	YVUO
餷	WYVG
諴	YDGT
帰	YTVH
赽	FHNW
萈	AHQY
裋	PUGU
邲	NTBH
蹍	KHNE
弁	CAJ
袗	PUWE
圕	LVFJ
唹	KYWU
繨	XFUP
銟	QMMH
馂	QNCT
広	YCI
掯	RHEG
幐	EUDH
轗	LDGN
斆	WFQT
堣	FJMY
蔏	AUMK
韾	FNMJ
鬁	DETJ
裷	PUUB
錼	QDFI
呶	KVCY
竑	UDCY
鸸	DMJG
癧	UDTH
蕂	AEUL
肸	EWFH
阣	BTNN
蓃	AVHC
龘	UEGD
蹻	KHTK
躜	KHTM
龂	HWBR
鴂	NWWO
橬	SAQJ
蟓	JQJE
樻	SKHM
蛆	JEGG
圵	FHG
猈	QTRF
闘	UGKF
瘽	UAKG
醪	SGNE
酡	SGPX
豂	WWKE
輂	AWLJ
駶	CNNK
葁	AUGV
籹	OVG
黹	OGUI
筗	TWKH
毚	QKXY
庽	YJMY
裏	HGJE
庻	YAWW
甓	NKUN
鵘	VTKO
﨡	JTGG
叾	BKF
雎	EGWY
狣	QTIQ
蜱	JRTF
萮	AWGJ
酓	WYNG
浧	IKGG
漈	IWFI
蜪	JQRM
鼃	FFMV
塻	FAJD
攰	FCLV
錀	QWGA
堷	FUJG
澞	IHAD
苅	AQJJ
宊	PDU
綼	XRTF
掓	RHIC
孾	BMMV
蘝	AWGW
滵	IPNM
灨	IUJM
鋷	QBCY
拞	RRGG
晊	JGCF
奬	NHDD
蒷	AKMU
鑖	QALT
椤	SLQY
絶	XQCN
鉥	QSYY
剼	CCCJ
窧	PWHJ
墭	FDNL
蒳	AXMW
糱	BTWO
槆	SAQJ
掆	RMUM
槅	SGKH
鍞	QHMY
胢	ESKG
釂	SGEF
聎	BIQN
勨	QJEL
穳	TTFM
艖	TEUA
饇	WYVK
虣	GAHM
撱	RBDE
玍	TFF
圸	FMH
飰	WYVH
砢	DSKG
縌	XUBP
雊	QKWY
櫱	BTWS
邿	FFBH
彠	VAKC
艴	XJQC
荈	AQAH
搎	RBTI
夬	NWI
鹆	WWKG
凕	UPJU
敽	TDKC
鶪	HDWO
坿	FWFY
橍	SUGG
镔	QPRW
摠	RTLN
墽	FRYT
滶	IGQT
囆	KAJJ
哠	KTFK
鷁	UWLO
熐	OPJU
鏚	QDHT
茇	ADCU
蠀	JUQM
馩	TJFM
寙	PRCY
偑	WMTJ
駈	CRGG
窻	PWTN
茙	AADR
檴	SAWC
栱	SAWY
赙	MGEF
抋	RNY
睅	HJFH
択	RNYY
恔	NUQY
歯	HOBJ
璬	GRYT
莾	ADFA
惿	NJGH
籅	TWFW
伂	WGMH
锔	QNNK
蔪	ALRJ
椕	SWVS
狷	QTKE
駓	CGIG
滽	IYVH
抧	RKWY
魝	QOJH
崉	MIJG
幯	MHTB
槏	SUVO
笣	TQNB
賸	EUDM
頠	QDBM
竰	UDJF
慻	NUDH
鈇	QFWY
躌	KHRH
靸	AFEY
妎	VWJH
桹	SYVE
銂	QYTH
婳	VGLB
襶	PUFW
鼛	FKUK
髷	DEMA
偋	WNUA
軂	TMDL
鹸	HLQW
鳆	QGTT
煶	OJGH
孭	BMY
蕻	ADAW
剰	TGAJ
幁	MHDM
塁	LIFF
貖	EEUL
鲞	UDQG
欗	SAUI
偦	WNHE
樳	SVAF
娍	VDNT
賶	MWYK
訞	YTDY
柧	SRCY
噊	KCBK
欙	SLLI
柰	SFIU
煁	OADN
栥	UQWS
逥	MJDP
燪	OAQN
毶	TFNE
猟	QTIH
佂	WGHG
靷	AFXH
劏	IPKJ
嗀	FPGC
孲	BGHG
刵	BJH
崞	MYBG
嶜	MAQJ
胓	EGUH
餆	WYVQ
髜	YMKA
觤	QEQB
啳	KUDB
駵	CGAN
蹮	KHSN
驌	CVHH
麚	YNJC
黅	AMWN
畺	GLGG
偅	WTGF
栍	STGG
阷	BGHG
兝	DQWV
灲	OJH
杌	SGQN
槇	SXHW
螝	JRQC
諨	YGKL
婑	VTVG
囸	LGHD
菔	AEBC
捃	RVTK
赥	FOQW
諎	YAJG
趧	FHJH
宒	PTFN
鉒	QYGG
酳	SGXE
磓	DWNP
犎	FFFH
冣	PBCU
瑂	GNHG
愵	NXUU
鹔	VIJG
煛	HHOU
裬	PUFT
窤	PWJX
鈙	QHCY
膗	EMWY
椺	SWKS
褹	PUFY
虁	AUHT
堬	FWGJ
耫	DIGM
鴑	VCWO
忦	NWJH
伾	WGIG
轓	LTOL
冐	JEF
阹	BFCY
鑇	QYVF
岇	MQBJ
跉	KHWC
靹	AFMW
砎	DWJH
糉	OQBT
禡	PYCY
婒	VOOY
桺	SGAN
筣	TTJJ
焂	WHTO
兣	DQDF
嵲	MTHS
坋	FWVN
摝	RYNX
铗	QGUW
鷪	HHPO
緆	XJQR
奊	FFGY
蛃	JGMW
鎋	QPDK
祶	PYUT
皏	RUAH
醯	SGYL
蘮	ALDJ
齶	HWWN
玌	GNN
莕	ASKF
踍	KHFB
醔	TOSG
軷	LDCY
瞉	FPGC
薕	AYUO
侽	WLLN
寛	PAHQ
猧	QTMK
塉	FIWE
雸	FAFF
靝	GERO
劽	GQJL
奲	DFTF
戤	ECLA
嗫	KBCC
蹎	KHFW
罞	LCBT
膕	ELAG
睮	HWGJ
皔	RJFH
梹	SRGW
坉	FGBN
孂	VTVL
盉	TLF
擃	RMAE
腂	EJSY
郌	FFKC
弞	XQWY
矂	HKKS
旇	YTHC
雴	FUF
杋	SMYY
蓙	AYWF
圛	LLFF
昛	JANG
躙	KHUY
躔	KHYF
耓	DISH
迖	DPI
瑳	GUDA
唡	KGMW
麶	SWWC
闚	UFWQ
苼	ATGF
袶	PUTH
跐	KHHX
徎	TKGG
鋽	QHJH
瘆	UCDE
痤	UWWF
讆	TNHY
斖	YWFG
嵧	MQYL
瓞	RCYW
鮧	QOGW
絖	XIQN
欥	JQWY
粡	OMGK
辧	UVUH
鮺	UDQO
飅	MTJL
焍	OUXT
籞	TTRI
糍	OUXX
鈋	QWXN
汱	IDY
熋	CEXO
鲩	QGPQ
艻	ALB
銒	QFTF
廑	YAKG
鍸	QDEG
鷈	WVGM
髞	YMKS
鵙	MWVO
匴	ATHA
癠	UYVF
俔	WHQN
龀	HWBX
牑	THGA
丅	GHK
蔒	AVTO
忴	NWYN
塧	FUWL
忳	NGBN
韱	WWAG
楕	SDAE
筴	TDWW
佭	WTAH
饐	WYVU
諣	YMNK
糦	OFKK
苈	ADLB
儗	WXTH
宩	POU
瀣	IHQG
璛	GVHH
汜	INN
潅	IRWY
傫	WLXI
膹	EFAM
嬘	VUEP
呏	KTAH
瘉	UWGJ
滺	IWHN
謯	YHAG
呚	KTY
庍	YRK
熚	OJAF
缃	XSHG
鹻	HLQO
囥	LYMV
瘵	UWFI
絬	XTDG
闀	UAWN
惙	NCCC
檦	SSFJ
誟	YFTB
亃	OQAN
鴪	PWWO
恗	NDFN
軤	LTUH
鍙	IAWQ
詺	YQKG
髵	DEDJ
袮	PUTI
噧	KAJY
欻	OOQW
嶡	MDUW
翆	NVFJ
隝	BWVO
囖	KTLY
亅	HHLL
牱	TRSK
垜	FESY
萢	AIQN
卟	KHY
緾	XDJF
焥	OPQB
嘷	KTHF
苶	AWIU
劅	LQJJ
梕	SVYN
喢	KTFV
曍	JTHF
郷	XTVB
禐	PYEC
飈	MTJO
棨	YNTS
鹝	GKMG
絷	RVYI
魸	QOTN
苆	AAVB
隭	BFDJ
爚	OWGA
霥	FPGE
笩	TWAU
佌	WHXN
銸	QBNN
侞	WVKG
淃	IUDB
篃	TNHF
牷	TRWG
锇	QTRT
蓪	ACEP
賎	MDXY
噺	KUSR
澰	IWGW
圬	FFNN
豳	EEMK
壾	FKUN
镮	QLGE
壿	FUSF
剗	AAJH
覍	IHQB
滠	IBCC
悎	NTFK
訒	YVYY
猃	QTWI
崪	MYWF
玔	GKH
胇	EXJH
懯	GEHN
楡	SWGB
渏	IDSK
飣	WYVS
鷘	GKIO
仩	WHG
奝	DMFK
滣	IDFK
墡	FUDK
欀	SYKE
髈	MEUY
湤	IYTB
刄	VYI
賳	MFAK
酀	AUKB
螵	JSFI
憍	NTDK
埵	FTGF
蓫	AEPU
甉	UVON
寴	PUSQ
槬	SDFY
遫	GKIP
颎	XODM
鲒	QGFK
齰	HWWJ
鼤	VNUY
戓	AKD
荹	AHIR
瘄	UAJD
瓱	GNYN
雓	WTWY
脙	EFIY
臇	EWYM
鼨	VNUU
扄	YNTK
訏	YGFH
鄀	ADKB
醶	SGWW
鞫	AFQY
茋	AQAY
帎	MHPQ
棡	SMUM
胮	ETAH
胒	ENXN
婄	VUKG
躟	KHYE
挷	RDTB
秾	TPEY
妉	VPQN
惾	NQBT
婗	VVQN
瑷	GEPC
瞝	HYBC
傊	WKMY
蟃	JJLC
椑	SRTF
嚺	KLUP
褽	NFIE
乁	YYLL
贶	MKQN
蓖	ATLX
爏	ODTH
譼	AHNY
蕡	AFAM
尮	DNES
槵	SKKN
傎	WFHW
豻	EEFH
脒	EOY
箁	TUKF
霟	FIAW
胋	EHKG
罙	PWSU
畣	WGKL
怾	NKWY
庒	YFYI
椯	SMDJ
卾	KKFB
蔈	ASFI
啌	KPWA
麨	SWWT
顑	DGKM
艈	TEYQ
鵫	HJWO
鉽	QAAG
遃	UTEP
屘	NTFB
鱲	QOVN
粷	OQOY
蛚	JGQJ
揎	RPGG
霷	FJJR
瓰	GNYV
粃	OXXN
傄	WDUH
巭	ALFW
靌	FPGM
彇	XVHH
姠	VTMK
轏	LNBB
漒	IXKJ
蒅	AIVS
旤	MNMQ
嵼	MUTG
袡	PUMF
襦	PUFJ
罃	OOPM
虂	AFKK
攕	RWWG
楘	CBTS
脰	EGKU
竗	UITT
阰	BXXN
馾	CPQN
鳡	QGDN
鄊	XTBB
黈	AMWG
騌	CPFI
箻	TTVH
陁	BTBN
臝	YNKY
恴	YJNU
籭	TGMX
酧	SGPF
鴓	NTWO
豘	EGBN
餩	WYVW
擖	RAJN
艽	AVB
賰	MDWJ
韽	WYNJ
闿	UMNV
牀	NHDS
噿	KNYF
裐	PUKE
鄛	VJSB
璚	GCBK
麀	YNJX
麘	YNJJ
屔	RGNX
蠠	DMJJ
硗	DATQ
鵁	UQWO
曕	JQDY
漽	INIH
鶲	WCNO
襔	PUAY
圧	DFD
摨	RNIH
飿	WYVM
昹	JYNI
鮝	UDQO
鼯	VNUK
嵵	MJFF
繎	XQDO
錵	QAWX
藔	APDI
樬	STLN
纕	XYKE
琝	GJYY
掤	REEG
釞	QTYY
栦	SYTH
杸	SMCY
姂	VTPY
娨	VJFH
弨	XVKG
刌	FJH
烰	OEBG
慁	LENU
澽	IHAE
祙	PYFI
凮	MDJD
奼	VTAN
卪	BYI
嬩	VWFW
荵	AVYN
饘	WYVG
氞	RNGW
姺	VTFQ
獔	QTRF
锧	QRFM
冟	PRXB
椂	SVIY
禝	PYLT
嬥	VNWY
喅	KJUG
漹	IGHO
佮	WWGK
傪	WCCE
覰	HAEQ
鴌	GDWO
乄	NYI
摥	RTJR
舕	TDOO
滉	IJIQ
藄	AADI
悛	NCWT
曡	JJJG
蛿	JWYK
舓	TDJR
骣	CNBB
飐	MQHK
睆	HPFQ
纒	XYJF
犻	QTGH
庼	YXDM
鼣	VNUD
踂	KHBN
囩	LFCI
錅	TQTQ
搒	RUPY
睖	HFWT
鋎	QPFQ
怐	NQKG
蠾	JNIJ
弴	XYBG
剬	MDMJ
鑩	QGKK
埐	FVPC
蜛	JNDG
琀	GWYK
謵	YNRG
槝	SWVM
蛽	JMY
珡	GGWU
鏛	QIPH
蝜	JQMY
軧	LQAY
諅	ADWY
恞	NGXW
邉	THPP
嶢	MFFQ
懛	NFKF
謮	YGMY
鐩	QUEP
鄿	AKKB
懅	NHAE
鴷	GQJO
蓅	AIYQ
権	SRWY
宑	PFJJ
晈	JUQY
鶠	AJVO
圐	LLYV
頟	TKDM
諘	YGEY
棴	SEBC
珶	GUXT
槦	SYVH
帪	MHDE
凟	UFLM
逫	CCCP
鸉	SJGO
萚	ARCH
汦	IQAN
樫	SAHF
跓	KHYG
耛	DICK
赺	FHWN
毼	JQWN
匂	QXV
顪	HDGM
钆	QNN
讵	YANG
佊	WHCY
蒾	AOPU
荅	AWGK
馌	QNFL
剠	YIJH
坸	FQKG
俿	WHAM
颒	IADM
埑	RRFF
呥	KMFG
俈	WTFK
罉	RMIR
樲	SAFM
峲	MTJJ
絵	XWFC
廎	YXDM
怬	NLG
埥	FGEG
汄	IWY
缡	XYBC
唼	KUVG
湳	IFMF
枨	STAY
澉	INBT
颹	MTJH
蒧	ADHT
岕	MWJJ
掜	RVQN
鼿	THLQ
縻	YSSI
廃	YWFQ
濷	IIAY
艅	TEWT
橪	SQDO
曘	JFDJ
憳	NVAF
粖	OGSY
慗	GKIN
搃	RUKN
篏	TAFW
瀯	IOOK
扝	RFNN
棿	SVQN
禷	PYOM
﨧	QFTB
篖	TYVK
葐	AWVL
獑	QTLR
躀	KHXM
豥	EYNW
賔	PNMU
姰	VQJG
騀	CTRT
艚	TEGJ
悈	NAAH
驠	CAUO
鈗	QCQN
俴	WAAT
酻	SGEB
礿	PYQY
郪	GVHB
謜	YDRI
檿	DJES
嵆	TDNM
啽	KWGA
囦	LII
洇	ILDY
隿	AWYG
瘼	UAJD
筁	TMAF
糳	OGUO
崹	MUPH
簤	TLMU
鰴	QOMT
桏	SABH
羒	UDWV
羼	NUDD
钔	QUN
鹇	USQG
旓	YTIE
咇	KNTT
駖	CWYC
酲	SGKG
誗	YTJH
莗	ALJ
頽	TMDM
鬹	FWHH
冁	UJFE
檰	SXRH
罟	LDF
鏦	QTWH
臵	GCFK
齘	HWWJ
镱	QUJN
暔	JFMF
砼	DWAG
碫	DWDC
爮	RHYN
藑	AQMT
紟	XWYN
焻	OJJG
鏩	QLRH
髱	DEQN
黫	LFOF
礇	DTMD
徸	TUJF
敔	GKTY
矖	HGMX
鳈	QGRI
頥	HAHM
綗	XMWK
﨑	MUSK
櫙	SAAK
贕	QYTM
瑆	GJTG
恲	NUAH
鯓	QOTT
粫	ODMJ
鋔	QQKQ
媋	VDWJ
攳	FCVF
濨	IUXN
罯	LUJF
襾	GMJG
穋	TNWE
甤	ETGD
嵺	MNWE
昿	JYCY
翪	NQBT
媹	VQYL
苺	AXGU
篹	THDB
鈂	QPQN
躆	KHHE
鵉	YOWO
韢	NHKN
娷	VTGF
懁	NLGE
趈	FHHK
漅	IVJS
狻	QTCT
罻	LNFF
葞	AXBF
鑝	QATP
樤	SWHS
宔	PYGF
菣	AAHC
嘝	KQEF
鈵	QGMW
臋	NAWW
忨	NFQN
忊	NSH
靵	AFNF
谇	YYWF
肵	ERH
雱	FYB
氥	RNSF
酟	SGHK
铓	QAYN
蕜	ADJN
荭	AXAF
庠	YUDK
峝	MMGK
盶	HFQN
螘	JMGU
諟	YJGH
偸	WWGB
狁	QTCQ
荙	ADPU
懄	NAKL
扻	RQWY
甖	MMGN
樉	SDQQ
橶	SFJA
蝒	JDMD
咰	KQJG
薀	AILL
帗	MHDC
嬣	VPNS
澿	ISSI
躄	NKUH
暍	JJQN
颟	AGMM
渓	IEFW
鯶	QOPL
逰	RTBP
黳	ATDO
唭	KADW
鲛	QGUQ
挓	RPTA
稁	YPTU
唪	KDWH
琠	GMAW
絅	XMKG
纴	XTFG
暽	JOQH
憢	NFFQ
撋	RUGG
郈	RGKB
瓂	GAFL
鉵	QJY
晹	JJQR
綒	XEBG
澁	IHHH
禣	PYGF
斒	YYNA
抌	RPQN
蜝	ADWJ
偱	WRFH
冔	JKGF
鈏	QXHH
霯	FWGU
獓	QTGT
锊	QEFY
雿	FIQB
咓	KGNN
斞	VWUF
茆	AQTB
珆	GCKG
垲	FMNN
鈫	QYY
匵	AFLM
尐	IYU
瀮	IFSS
麍	YNJQ
瀓	ITMT
燩	ORYT
竃	PWFN
貅	EEWS
旵	JMJ
吂	YNKF
暩	JWFI
旀	YCIY
鼖	FAFC
肍	EVN
緓	XAMD
郆	FKBH
踻	KHMK
玭	GXXN
踔	KHHJ
憀	NNWE
鎹	QUDP
嬵	VXRH
鮕	QODG
嵾	MCCE
漘	IDFE
澾	IFUP
鶌	NBMO
寋	PFJB
劎	WGKV
餺	WYVF
軱	LRCY
蝫	JFTJ
櫑	SLLL
臸	GCFF
蹞	KHXM
蒓	AXGN
硁	DCAG
攧	RFHM
蓕	ASFF
欴	YVCW
貎	EEVQ
珱	GIVG
塝	FUPY
螙	SJJU
朌	EWVN
硔	DAWY
掭	RGDN
拸	RQQY
蝅	GDGJ
﨟	AEJN
蔌	AGKW
蝞	JNHG
螧	JFTJ
瀽	IPFH
嶤	MFFQ
獊	QTWK
喦	KKKM
閍	UYV
懡	NYSC
簙	TFGF
騥	CCBS
伹	WEGG
賝	MPWS
纁	XTGO
梸	STJH
艗	TEUL
胕	EWFY
柣	SRWY
偂	WUEJ
佫	WTKG
塜	FPGE
疨	UAHT
凨	MFCI
縬	XDHT
氍	HHWN
嶓	MTOL
羦	UDPQ
寈	PGEF
聜	BPWA
嫹	VAMW
爧	OFKW
荕	AELB
彔	XGIU
噍	KWYO
媱	VERM
夈	TOU
樌	SXFM
卌	GLK
囕	KAHQ
芠	AYU
嶵	MLDD
鰵	TXGO
埧	FHWY
潾	IOQH
欸	CTDW
薚	AGQR
湏	IDMY
圼	JFF
蚢	JYMN
炋	OGIY
輠	LJSY
傸	WDQQ
嵷	MTWH
疜	UGHI
躐	KHVN
煫	OUEY
泩	ITGG
蓺	AFWY
馢	TJAA
緂	XOOY
頲	TFPM
嘳	KKHM
砀	DNRT
偘	WKKK
幥	MHIR
洌	IGQJ
璖	GIAS
鬎	DEGJ
硈	DFKG
漵	IWTT
澊	IUSF
锎	QUGA
眗	HQKG
疩	UVFK
櫆	SRQF
麖	YNJI
爞	OJJJ
窴	PWFW
怙	NDG
伧	WWBN
鉰	QNGK
泈	ITUY
妭	VDCY
夲	DFJ
臽	QVF
愯	NWYC
頀	UJAC
瀄	ITVB
痾	UBSK
糹	XNNY
沠	IRHY
秄	TBG
梫	SVPC
剳	AWGJ
嘥	KTHH
偬	WQRN
醝	SGUA
蔛	AQEF
箼	TNGF
祰	PYTK
愭	NFTJ
辎	LVLG
礊	LBMD
焠	OYWF
橝	SSJH
嵞	WTMM
蟿	LBMJ
硡	DPDC
璻	GNYF
渌	IVIY
殩	GQHO
鐂	QGAL
篛	TXUU
舏	TDNH
觻	QEXS
榟	SPUH
贠	CMU
塪	FEVG
哰	KPRH
莍	AFIY
疧	UQAV
氄	CBTN
鱚	QOFK
廜	YNFJ
魹	QOTN
螅	JTHN
鯆	QOGY
鼂	JGMV
蝻	JFMF
鱪	QOJJ
傱	WTWH
栄	IPSU
皢	RFFQ
謩	AJDY
拹	RLLL
桘	SWNN
翓	FKNG
憞	NYBT
梽	SFNY
鋴	QDQN
臞	EHHY
夿	DCB
瑘	GBBH
啇	UMDF
壜	FJFC
黁	YSSJ
謱	YKGV
伛	WAQY
鈱	QNAN
堟	FXEY
鴭	WNNO
芔	BHBH
膪	EUPK
敁	HKHC
柷	SKQN
鶸	XUXO
訤	YQQY
馟	TJEB
侀	WGAJ
狓	QTHC
耎	DMJD
捒	RGKI
晅	JGJG
吚	KVTT
懚	NEAN
虺	GQJI
苲	ATHF
謈	JAWY
蒀	AJLF
浵	IMYE
檶	SDAK
馿	CYNT
癃	UBTG
皪	RXRS
禳	PYYE
挢	RTDJ
莪	ATRT
鮥	QOTK
囘	MNV
夻	DKF
侴	WGNJ
鳹	WYNO
溒	IFKE
徚	TGLI
飻	WYVE
縩	XWFI
畒	YLWY
瞵	HOQH
囙	LND
猺	QTEM
燢	WFQO
畇	LQUG
鷨	AGAO
汻	ITFH
岤	MPWY
哜	KYJH
晩	JQJQ
訵	YLG
崼	MJGH
姾	VWGG
錴	QFWF
濭	IAFL
篸	TCCE
橆	RLGS
瑫	GEVG
屗	NTFF
眤	HNXN
珔	GDHB
岆	MTDY
厒	DRMK
痚	UFTB
耴	BNN
鐍	QCBK
揱	IEJR
榇	SUSY
芄	AVYU
髶	DEBF
嶰	MQEH
縒	XUDA
凗	UMWY
犺	QTYM
缦	XJLC
跸	KHXF
澂	IMGT
趬	FHFQ
魣	QOCB
灁	IURI
睯	NATH
吇	KBG
煃	ODFF
鮍	QOHC
塇	FPGG
葪	AQEJ
尗	HIU
鋡	QWYK
辬	UYUH
鷒	GJHO
锼	QVHC
鍻	QJQN
嚧	KHAL
谖	YEFC
鞈	AFWK
筎	TVKF
焅	OTFK
誻	YIJG
哢	KGAH
耏	DMJE
竂	PWDI
昄	JRCY
炦	ODCY
諵	YFMF
鼟	FKUU
龓	DEUD
磟	DNWE
鵏	GEHO
蚶	JAFG
歏	AKGW
茖	ATKF
婐	VJSY
匒	QAWK
敠	CCCC
袰	XGUE
鼜	FKUJ
薿	AXTH
瓭	PQGN
怟	NQAY
涀	IHQN
鉶	QGAJ
稏	TGHG
赹	FHQU
狛	QTRG
珼	GMY
艝	TEFV
餈	UQWE
琩	GJJG
恎	NGCF
媝	TOVF
剓	TQTV
蝑	JNHE
馻	CCQN
姧	VVFH
厃	QDR
袩	PUHK
秡	TDCY
灙	IIPO
慥	NTFP
艭	TEWC
楟	SYPS
閟	UNTE
溸	IGXI
蝲	JGKJ
塷	FHLO
湹	IDJF
傜	WERM
熿	OAMW
萁	AADW
満	IAMM
峚	MDFF
稐	TWGA
虳	JQYY
琗	GYWF
埮	FOOY
饸	QNWK
喼	KQVN
焔	OQHJ
稫	TGKL
昣	JWET
埪	FPWA
柢	SQAY
夘	QBH
氀	KGKN
姮	VGJG
沩	IYLY
吪	KWXN
拊	RWFY
験	CWGW
遦	XFMP
鯋	QOIT
毧	TFND
絋	XYCY
唨	KBEG
漙	IGJF
跴	KHSG
貤	MBN
晑	JTMK
舴	TETF
椉	YQAS
蔝	AHOU
噚	KVAF
曌	JEPA
耾	BDCY
錃	IHCQ
惔	NOOY
扞	RFH
棪	SOOY
樛	SNWE
飦	WYVF
礸	DTFM
撀	FNMR
榲	SLWL
裩	PUJX
觢	DHVE
躻	TMDA
霮	FIAN
薂	ARYT
謧	YYBC
鯯	QORJ
羺	UDFJ
諀	YRTF
磲	DIAS
淝	IECN
虶	JGFH
佉	WFCY
菃	AIAN
禒	PYXE
紣	XVFH
溤	ICY
哫	KKHY
髤	DESU
桬	IITS
躶	TMDS
頵	VTKM
藊	ATYA
齆	THLC
粝	ODDN
弍	AFD
乿	EXIN
艒	TEJH
篭	TUJN
崨	MGVH
粯	OHQN
騹	CAKG
晿	JJJG
钪	QYMN
鵎	EVWO
傿	WGHO
鳱	FWVO
甑	ULJN
盨	EDML
諃	YSSY
鸶	XXGG
袷	PUWK
珄	GTGG
芞	ARNB
艜	TEAH
砈	DDBN
鯞	QOVH
尶	GQAL
鄸	ALPB
綧	XYBG
焴	OYCE
檾	OOPS
焓	OWYK
踳	KHDJ
茿	AAMY
醈	SGOO
晼	JPQB
厤	DTTI
煐	OAMD
錹	QHEG
饏	NBTE
簖	TONR
琱	GMFK
椀	SPQB
庯	YGEY
鴡	EGWO
謴	YXFM
唻	KSWW
垳	FTFH
朷	SVN
薍	AECN
灂	IELF
鵣	GKIO
眡	HQAY
珌	GNTT
唺	KMAW
恄	NFKG
愋	NEFC
萂	ATKF
輚	LAAT
檚	SSSH
奅	DQTB
盵	HTNN
裈	PUPL
耲	DIYE
伔	WPMN
覐	HQQQ
讉	YKHP
愖	NADN
貚	EEKF
蠊	JYUO
籔	TKGT
脟	EEFY
迒	YMPV
鏮	QYVI
惈	NJSY
瘖	UUJD
呺	KKGN
瞍	HVHC
虃	AIWG
餲	WYVN
脢	ETXU
蚸	JRYY
厧	DFHW
聁	BWVN
晻	JDJN
鏆	QXFM
觺	XTDE
癵	UXYW
揢	RPTK
鲦	QGTS
鞌	PVAF
櫩	SUQV
挅	RESY
苙	AUF
峇	MWGK
鳨	WVGL
鼵	VNUD
鮋	QOMG
姤	VRGK
貁	EEPW
勴	HALL
齕	HWWN
綀	XGKI
竴	UUSF
踣	KHUK
箑	TGVH
頍	FCDM
擓	RAIY
賆	MUAH
愀	NTOY
豾	EEGG
攑	RWFH
娵	VBCY
抷	RGIG
溙	IDWI
樮	SSOY
潏	ICBK
菾	AGDN
鑴	QMWK
縕	XLWL
衋	VFHL
侻	WUKQ
臛	EFWY
唲	KVQN
艵	UAQC
鑹	QPWN
泃	IQKG
涗	IWKQ
啗	KQVG
摣	RHAG
剣	WGKJ
莂	AKLJ
檛	SMNP
嶝	MWGU
碋	DMSK
褍	PUMJ
肹	EWGN
黀	YSSC
侊	WIQN
哛	KXWV
殢	GQAH
郠	GJQB
嚹	KRMH
雈	GJGY
肐	ETNN
軣	LIU
撦	RDFJ
鵚	TMWO
斸	NILR
邈	EERP
藮	ASWO
睄	HIEG
羷	UDWW
泑	IXLN
縸	XAJD
籺	OTNN
炌	OWJH
飝	NUTH
魢	QONN
瓝	RCYY
蔉	AUKE
奙	CDJN
仌	WWU
禔	PYJH
廇	YQYL
郚	GKBH
駼	CWTY
厳	IDNT
腨	EMDJ
頚	CFDM
巏	MAKY
磩	DDHT
萡	AIRF
鮼	QOVC
彴	TQYY
狅	QTTF
觨	QEAI
瑴	FPGC
陴	BRTF
秜	TNXN
爜	OOGC
睓	HMAW
樇	SWHE
篂	TJTG
洏	IDMJ
穟	TUEP
迣	ANPV
挐	VKRJ
碝	DDMD
飥	WYVN
詟	DXYF
鄇	WNTB
鬊	DEDJ
稒	TLDG
礝	DFDJ
縍	XUPY
蹔	LRKH
瀇	IYAW
俹	WGHG
溌	IWFQ
覝	FOHQ
錝	QPFI
飊	OOOJ
牬	TRTT
莶	AWGI
嘡	KIPF
簃	TTQQ
鐻	QHAE
媙	VDGT
鹠	QYVG
錏	QGHG
鶹	QYVO
昑	JWYN
蟪	JGJN
鮴	QOWS
蜐	JFCL
摀	RWNO
鼁	FCMV
眵	HQQY
蝡	JDMD
剚	GKVJ
磆	DMEG
迯	QHPI
擹	RAKW
凪	MHD
侎	WOY
詏	YXLN
昸	JTUY
婛	VYIY
樍	SGMY
蹆	KHVP
吜	KNFG
晙	JCWT
翜	NDWW
卐	NGHG
濧	IOGF
揃	RUEJ
寲	PXTH
氠	RNJH
龆	HWBK
駮	CUQY
譑	YTDK
汑	ITAN
隡	BUTG
韅	AFJO
癁	UTTT
蛑	JCRH
皧	REPT
绾	XPNN
虘	HAEG
餦	WYVE
鮽	QOWT
瘰	ULXI
穲	TGMX
幋	TEMH
觿	QEMK
霨	FNFF
穐	TQJN
榓	SNTL
鑸	QLLF
塂	FAWN
菈	ARUF
脩	WHTE
続	XFPQ
臱	THPY
侹	WTFP
跥	KHES
勊	DQLV
帴	MHAA
泟	IGHG
簩	TOOL
兿	URVC
軦	LKQN
鬠	DEWJ
麯	SWWA
侼	WFPB
熲	XODM
沀	ICBH
塺	YSSF
瑝	GRGG
卛	XYXF
朄	JHGI
蘒	ATQN
濈	IKBT
豑	MAGT
禠	PYRM
脡	ETFP
噑	KRIF
邷	GNYB
匼	AWGK
褢	YRQE
骖	CCDE
鎸	QWYE
屓	NMI
蒰	ATEC
腗	EMGJ
飷	WYVG
庎	YWJK
囗	LHNG
韏	UDNH
豮	EFAM
鏳	QULJ
烔	OMGK
堏	SYFF
紌	XDNN
厰	DIMT
蛧	JMQQ
硦	DGAH
覊	SAFC
檲	SLGF
噾	KPWJ
崄	MWGI
憗	SWWN
熫	OYAO
桖	STLG
砘	DGBN
鏕	QYNX
楥	SEFC
疁	LNWE
韒	NHKE
蜧	JYND
蔇	AVCQ
纇	OXIM
挋	RAHH
荌	APVF
覨	KKFQ
顚	XHNM
罸	LYFU
厏	DTHF
芆	ACYU
躳	TMDK
樕	SGKW
誈	YGCF
韈	AFAT
珁	GGNN
麎	YNJE
趒	FHIQ
爟	OAKY
諌	YGJI
愇	NNHH
膋	OOPE
趻	KHWN
桳	SCDF
栟	SUAH
洭	IAGG
湷	IDWJ
勓	XXRL
帾	MHFJ
聈	BXLN
嗊	KAMY
姭	LLLV
穙	TOGY
埲	FDWH
傔	WUVO
訆	YNHH
簭	TAWK
圪	FTNN
黋	IQAW
綉	XTEN
醳	SGLF
廹	RPD
蛒	JTKG
硥	DDNE
篅	TMDJ
氼	IWU
娿	BSKV
栆	GKHU
轝	WFGL
眓	HANT
猂	QTJF
邚	VBH
漶	IKKN
疀	VLGH
鉝	QUG
锛	QDFA
砜	DMQY
慉	NYXL
馽	CKHJ
濅	IPVC
鵀	WTFO
謕	YRHM
剭	NGCJ
﨔	SIWR
鰞	QOWO
昬	NAJF
爴	LAKY
絴	XUDH
龝	TTMG
鲷	QGMK
禞	PYYK
繶	XUJN
劕	RRMJ
砉	DHDF
頨	NDMY
棩	STHH
潃	ITTE
堫	FQBT
虯	JNHH
膸	EDAP
垈	WAFF
鑅	QOOS
鴋	YWVO
淧	IPNT
聴	BFLN
柪	SXLN
勽	QWI
飵	WYVF
僿	WPFF
蓒	ALFJ
魵	QOWV
躠	AWNH
嬺	VAAN
槭	SDHT
稪	TTJT
墬	BXEF
孡	BCKG
溄	IMTH
剆	YVCJ
葕	ATIH
覄	SWDU
灷	OAJ
湪	IXEY
饊	WYVT
锸	QTFV
珹	GDNT
梣	SMWN
甧	TGTE
陭	BDSK
瓇	GDET
煏	OGKL
誾	UYD
梬	SMGN
朼	SXN
砛	DWYN
匫	AQRJ
洎	ITHG
淴	IQRN
蜺	JVQN
垝	FQDB
嶱	MAJN
鮠	QOQB
鴔	TPWO
鹎	RTFG
鴚	WVGK
懽	NAKY
纚	XGMX
肨	EDHH
碒	DQG
徆	TSG
稓	TAJG
徶	TUMT
鴘	CAWO
鷭	TOLO
徼	TRYT
銯	QXIY
偟	WRGG
潒	IQJE
駠	CQTB
瑢	GPWK
屍	NGQX
兘	FQCK
鰮	QOLL
錻	QGAH
羍	DUDJ
汮	IQUG
崒	MYWF
贚	MUED
耧	DIOV
寱	PNHS
蘪	AYNO
瘯	UYTD
獿	QTDT
悗	NQKQ
汸	IYN
樖	WGKK
禋	PYSF
涢	IKMY
緳	YDHI
緛	XDMD
繲	XQEH
猀	QTIT
罶	LQYL
璮	GYLG
孠	NGKB
駾	CUKQ
饚	WYVL
熁	OLLE
鸙	WGKO
櫒	SAWI
媉	VNGF
圔	LFCL
爌	OYAW
晀	JIQN
萭	ATKY
蓘	AUCE
詇	YMDY
芎	AXB
躃	KHNU
遹	CBTP
晱	JOOY
氕	RNTR
譆	YFKK
挘	RITL
勧	RWYL
訅	YVN
爿	NHDE
顉	QDMY
漥	IPWF
庢	YGCF
虒	RHAM
篊	TIAW
睒	HOOY
饓	WYVS
菳	AQF
烒	OAAG
褕	PUWJ
顕	JOGM
癹	WMCU
庑	YFQV
濢	INYF
薣	AFKC
跬	KHFF
邘	GFBH
鬯	QOBX
鐕	QAQJ
黧	TQTO
撆	UMIR
縰	XTHH
檨	SUGW
槪	SRXQ
僎	WNNW
忚	NBN
儇	WLGE
搋	RRHM
綅	XVPC
蔘	ACCE
経	XCFG
礆	DWGW
茼	AMGK
瀌	IYNO
奱	XYXD
懕	DJEN
鉾	QCRH
馵	CAJ
醱	SGWC
訲	YKHH
倇	WPQB
槺	SYVI
稡	TYWF
椛	SAWX
芉	AFJ
勚	ANML
紞	XPQN
鼋	FQKN
瞾	HHPA
鱴	QOAT
溁	IAPS
酔	SGVF
鼒	FTHN
軥	LQKG
鐼	QFAM
闅	UHHC
漐	FUFI
氷	YII
痗	UTXU
駇	CTY
摖	RWFI
輌	LGMM
讏	TNHY
箟	TJXX
墯	NDAF
艉	TENN
闼	UDPI
紨	XWFY
覩	FTJQ
屖	NUK
勏	UKLN
骿	MEUA
鬡	DEPS
怍	NTHF
裛	YCEU
囇	KGMX
萏	AQVF
嘼	KKLK
黬	LFOT
祻	PYLD
獇	QTUC
慖	NLAG
蚭	JNXN
堁	FJSY
粆	OITT
瓗	GMWK
鶏	EFWO
髸	DEAW
甔	QDWN
趩	FHLW
鞇	AFLD
龥	WGKM
耜	DINN
蚅	JDBN
凓	USSY
廞	YQQW
暛	JUDA
淠	ILGJ
龣	WGKI
耩	DIFF
迧	JHPK
奦	CBTD
襰	PUGM
惁	SRNU
糀	OAWX
嗻	KYAO
罛	LRCY
揌	RLNY
稊	TUXT
駷	CGKI
聕	BTFK
仭	WVYY
獈	QTUL
妸	VSKG
敂	QKTY
嬢	VUFE
亝	CCCF
盠	XELF
糁	OCDE
儱	WUED
釺	QTFH
巶	VKNN
醼	SGAO
弅	WVAJ
沬	IFIY
頾	EDMX
皠	RMWY
硇	DTLQ
歋	RHAW
螫	FOTJ
鳙	QGYH
蒍	AYTO
瞊	HYVK
仜	WAG
葔	AWND
脘	EPFQ
嶑	MQJE
梺	SSGH
槉	SUTD
軇	TMDF
洖	IKGD
洳	IVKG
軨	LWYC
旔	YVFP
扴	RWJH
穓	TLAW
慝	AADN
輀	LDMJ
朐	EQKG
粀	ODYY
笱	TQKF
愗	CBTN
蕇	AKKF
欨	QKQW
赯	FOYK
浗	IFIY
斶	RLQJ
爁	OAHL
矑	HHAL
琂	GYG
簯	TSAW
尃	GEHF
稵	TUXX
郩	QDEB
攍	RYNY
佄	WAFG
謲	YCCE
褁	JSEU
爓	OUQV
烢	OPTA
狘	QTAT
犅	TRMM
祪	PYQB
枘	SMWY
鈊	QNY
碬	DNHC
蔎	AYMC
鸃	WVGT
褠	PUFF
刬	GJH
抜	RDCY
梀	SGKI
傐	WYMK
牗	THGH
碂	DPFI
巇	MHAA
瑧	GDWT
挱	RIIT
偧	WDQQ
虇	AXAY
稺	TNUH
罤	LUXT
墰	FSJH
赮	FONC
迾	GQJP
蠍	JJQW
芓	ABF
岪	MXJJ
萫	ATJF
蟌	JTLN
檓	SVAC
浨	IPSY
楽	RISU
萀	AHAM
堽	FLGH
嬚	VYUO
挮	RUXT
犔	TRRO
愓	NJGR
蒠	ATHN
萗	APFI
鷧	FPGO
刏	RNJH
怮	NXLN
譭	YVAC
帟	YOMH
伭	WYXY
糂	OADN
葰	AWCT
兠	URXQ
藼	APGN
捾	RPNN
轙	LUGT
箌	TGCJ
簓	TMFE
灴	OAG
嶌	MWVO
鵾	JXXO
缒	XWNP
哕	KMQY
蒈	AXXR
鮨	QOXJ
籘	TEUI
濜	IVHL
笗	TTUU
弮	UDXB
蚈	JGAH
唙	KQTO
嫧	VGMY
袎	PUXL
陚	BGAH
靪	AFSH
亍	FHK
偮	WKBG
袃	AVYE
媮	VWGJ
藘	AHAN
菙	ATGF
帬	VTKH
妗	VWYN
凾	BKCB
膙	EXKJ
巉	MQKY
沨	IMQY
翐	NRWY
猡	QTLQ
骦	CFSH
蝷	JYUT
煻	OYVK
釲	QNN
廆	YRQC
湵	IUGY
鯠	QOSW
勅	GKIL
勰	LLLN
煂	OAFH
鉏	QEGG
巁	MDAY
畼	LJGR
蕄	AUNU
檮	SFNF
嚗	KJAI
藳	AYMT
縪	XJAF
疛	UFI
骘	BHIC
鼪	VNUG
漧	IFJN
躝	KHUI
矐	HFWY
囷	LTI
琜	GSWW
碢	DMNK
輭	LDMD
鴫	LWVO
挔	RYEY
瘻	UKGV
轋	LLPY
唓	KLH
楧	SAMD
愱	NUTD
妿	LKVF
匌	QWGK
唽	KSRH
珛	GDEG
嵸	MTWH
呅	KYY
堛	FGKL
圦	FTYY
徥	TJGH
淐	IJJG
諔	YHIC
踜	KHFT
鷼	UJWO
雧	WYWS
蟗	GKHJ
燇	OUSF
璔	GULJ
耰	DIDT
嬶	VTHJ
黓	LFOA
仴	WEG
汅	IGNN
嶊	MRWY
螼	JAKG
粁	OTFH
逘	CTDP
鴎	AQWO
譔	YNNW
穾	PWTD
鱹	QOAY
繐	XGJN
劓	THLJ
潽	IUOJ
溡	IJFF
繑	XTDK
珗	GTFQ
躎	KHGQ
憰	NCBK
鐆	BUEQ
潶	ILFO
湜	IJGH
姫	VAHH
腶	EWDC
鱐	QOVH
刋	TDJH
苂	AOU
両	GMMK
翯	NYMK
槯	SMWY
粶	OVIY
軑	LDY
伻	WGUH
犥	TRYO
宷	PTOU
尦	WQQY
迗	GDPI
橸	SJJJ
氇	TFNJ
瘬	UXDE
郿	NHBH
甹	MGNB
齉	THLE
鬒	DEFW
錞	QYBG
惛	NQAJ
瘎	UADN
峕	MYJF
袧	PUQK
纆	XLFF
夎	WWFT
蔤	APNM
旳	JQYY
宨	PIQB
欅	SWFR
嫅	VUDA
漴	IMPI
乫	LKNB
卆	VFJ
朘	ECWT
梡	SPFQ
绁	XANN
寊	PHMU
陃	BGMW
桽	SWWF
烡	OAWU
巵	RGCV
瀈	INPL
瀊	ITEL
斄	FITW
蚼	JQKG
鋋	QTHP
譊	YFFQ
烶	OTFP
岨	MEGG
珻	GTXU
韣	NHKJ
咑	KRSH
蚑	JFCY
饩	QNRN
軓	LMYY
伨	WQUG
漊	IKGV
藿	AFWY
烸	OTXU
迏	DYPI
殰	GQFM
牫	TRAT
跫	AMYH
秷	TGCF
皾	FLMC
訋	YQYY
聻	ILRB
斈	YBF
嫐	VLLV
禙	PYUE
丒	VYGF
塛	FSSY
伵	WLG
漀	FNMI
揓	RYTB
嚪	KUQV
窀	PWGN
邟	YMBH
騆	CMFK
瀥	INYK
櫠	SYWC
堢	FWKS
媎	VFTJ
磃	DRHM
櫄	STGO
椄	SUVG
鼞	FKUF
鴵	IQWO
槮	SCCE
牄	NHDK
鳯	MWVO
蟋	JTON
轒	LFAM
様	SUGI
珬	GDGT
鬀	DEUT
崾	MSVG
倛	WADW
箘	TLTU
灗	IJYG
毊	FNMK
蠵	JMWK
煆	ONHC
濬	IHPH
绠	XGJQ
籛	TQAA
褰	PFJE
馡	TJDD
湶	IRIY
竐	UMCY
鈲	QRCY
浝	IDNE
聉	BBMH
棅	STGI
蚇	JNYY
枆	STFN
寏	PQMD
婹	VSVG
淕	IFWF
裑	PUTT
餏	WYVE
鳷	FCWO
妜	VNWY
鳚	QGNF
煸	OYNA
糋	OUEJ
旫	JVN
翑	NQKG
缵	XTFM
饢	WYVE
譝	YMGV
傺	WWFI
杩	SCG
瞫	HSJH
忎	TFNU
蝖	JPGG
鯷	QOJH
芌	AFNB
廒	YGQT
聏	BDMJ
奆	DANF
琡	GHIC
裻	HICE
鼦	VNUK
淣	IVQN
踖	KHAJ
櫿	SOOK
鳇	QGRG
丣	GAJN
鉂	QKQY
絪	XLDY
舯	TEKH
眏	HMDY
畯	LCWT
椼	STIH
湆	IUJG
幤	IMKH
絁	XTBN
礈	DUEP
拻	RDOY
痜	UTMV
瞲	HCBK
崰	MVLG
鋵	QTMN
馉	QNME
蘁	AGKK
篴	TEPU
茕	APNF
矷	DBG
剅	GKUJ
莋	AWTF
尙	IMKF
癕	UYXY
榺	EUDS
鴹	UDWO
銌	QDHB
讁	YUMP
泦	INVN
墌	FYAO
蚽	JGIG
觫	QEGI
柦	SJGG
丌	GJK
硠	DYVE
銡	QFKG
舣	TEYQ
屣	NTHH
锩	QUDB
脄	EDOY
瓥	RCYJ
訹	YSYY
蒖	AFHW
洦	IDJG
亾	WNV
眽	HREY
銽	QQAK
躧	KHGX
顜	FJGM
讟	YFLY
麧	SWWN
抇	RJG
悪	GKJN
揁	RHMY
郺	QQVC
鵆	TWVH
鍴	QMDJ
芛	AVTR
偤	WUSG
訔	MYF
踚	KHWA
薁	ATMD
埣	FYWF
桟	SDXY
鰋	QOAV
刐	MYJH
殙	GQQJ
聡	BWCN
鎅	QLWJ
堾	FDWJ
豅	WWKD
婲	VAWX
橖	SIPS
嚆	KAYK
釳	QTNN
糵	AWNO
髄	MEDP
肁	YNVH
鬉	DEQT
镘	QJLC
儛	WRLH
侤	WFTN
鯅	QOTP
忬	NCBH
睙	HYND
糔	OCYJ
桝	SQAH
窎	PWQG
圴	FQYY
芚	AGBN
孻	BVHL
螑	JTHD
悌	NUXT
铍	QHCY
螋	JVHC
駳	CTHP
滳	IUMK
詧	WYF
濔	IGWQ
匦	ALVV
聠	BUAH
垼	TMCF
愰	NJIQ
蕗	AKHK
聸	BQDY
絉	XSYY
腧	EWGJ
臕	EYNO
嵉	MYPS
皯	HCFH
霻	FMAU
骺	MERK
婱	XYXV
喖	KSDG
萆	ARTF
鳠	QGAC
齨	HWWV
斘	QUFH
偹	WHTL
蜠	JLTY
擆	RAFJ
珘	GTEY
鬜	DEUE
洟	IGXW
霱	FCBK
癳	ULLI
慺	NKGV
怤	WFNU
幱	MHUI
鲻	QGVL
稲	TEHJ
嵫	MUXX
铳	QYCQ
飉	MTJI
螱	NFIJ
髎	MENE
仐	WFJ
祊	PYYN
騺	FUFC
靭	AFVY
杙	SAY
籇	TYPE
娭	VCTD
芣	AGIU
朻	SNHH
浱	IDFE
鑃	QNWY
摂	RBIY
蒁	ASYP
皛	RRRF
轕	LAJN
騿	CUJH
歕	FAMW
殌	GQGA
鞹	AFYB
蘤	AREO
欍	SAWV
埩	FQVH
蜌	JXXF
脤	EDFE
傇	WABG
磴	DWGU
犆	TRFH
峛	MGQJ
閗	UUFK
瀃	IMJR
觲	QEUH
庨	YFTB
霕	FFCN
婇	VESY
霛	FXXX
覹	HQTT
姛	VMGK
铊	QPXN
蚳	JQAY
垹	FDTB
緧	XUSG
嵿	MSDM
桸	SQDH
鳎	QGJN
袝	PUWF
峓	MGXW
啠	RRKF
圮	FNN
緪	XNGG
鑧	QPAY
掚	RGMY
艄	TEIE
啚	KFLK
劦	LLLB
軜	LMWY
犠	TRUT
橿	SGLG
曎	JLFF
飳	WYVG
髼	DETH
銉	QVFH
浍	IWFC
蟦	JFAM
熣	OMWY
璌	GPGW
魭	QOFQ
噋	KYBT
鸔	WVGI
藁	AYMS
衠	TFHH
瓎	GGKM
恫	NMGK
拕	RPXN
憱	NYIN
缹	RMOU
莔	ALWM
椔	SVLG
稧	TDHD
尡	IQJX
丵	OGUF
墹	FUJG
劂	DUBJ
竀	PWGQ
幚	DTBH
哣	KGKU
衂	TLVY
佁	WCKG
砨	DYNN
婮	VNDG
竧	UTMT
焳	OWYG
秕	TXXN
穅	TYVI
栐	SYNI
趶	KHGF
鷡	RLGO
紵	XPSH
硵	DHLQ
喕	KDMD
飮	WYVW
麬	SWWC
盭	XFUL
黰	LFOW
簺	TPFF
痁	UHKD
畛	LWET
韮	ADJG
搦	RXUU
沲	ITBN
攎	RHAL
蜞	JADW
篚	TADD
獁	QTCY
爉	OVLN
谔	YKKN
悕	NQDH
誺	YSWW
醷	SGUN
鼭	VNUF
鱋	QOHG
魟	QOAG
憘	NFKK
媁	VNHH
黵	LFOY
箯	TWGQ
坵	FRGG
嫮	VFFN
婎	VWYG
嫬	VYAO
鱫	QOET
洢	IWVT
冹	UDCY
獝	QTCK
猒	JEDY
嵔	MLGE
蒆	AAMV
噛	KHOB
蜤	SRJU
栛	SLLL
螹	JLRH
墴	FAMW
瘑	UMNK
祔	PYWF
泐	IBLN
緐	TXGI
轷	LTUH
茷	AWAR
庉	YGBN
踬	KHRM
敾	UDUT
梮	SNNK
蒝	ADRI
譪	YAJN
嫝	VYVI
黙	JFDO
饎	WYVK
嵻	MYVI
鐇	QTOL
悋	NYKG
翴	NLPY
嬽	VLHD
堖	FVTQ
舺	TELH
疶	UANV
溊	INHC
籋	TGWQ
鱅	QOYH
鉡	QUFH
魧	QOYM
籦	TQTF
乻	YWUN
荂	ADFN
瀴	IMMV
迿	QJPD
頮	IADM
咢	KKFN
釫	QFNN
犣	TRVN
宻	PCUM
矻	DTNN
湝	IXXR
橕	SIPT
汋	IQYY
鍪	CBTQ
狌	QTTG
蝣	JYTB
湱	IDHD
烳	OGEY
蓎	AYVK
毩	TFNO
崬	MGJI
夐	QMWT
艼	ASJ
霗	FIWC
暊	JDMY
鴽	VKWO
憄	TFHN
溆	IWTC
嶥	MDUW
爔	OUGT
姲	VPVG
檧	SAQN
甯	PNEJ
婞	VFUF
鶝	GKLO
祮	PYFK
朇	WGLF
灓	XYXI
仂	WLN
夀	FNKF
兛	DQTF
済	IYJF
簈	TNTF
矨	TDTD
姏	VAFG
廵	VPV
抂	RGG
夂	TTNY
珳	GYET
疒	UYGG
澐	IFFC
肂	GQVH
涷	IGJI
籱	TFWY
萅	AGBJ
摾	RXKJ
荲	AJFF
篥	TSSU
嚜	KLFF
佦	WDG
夳	DFF
跁	KHCN
碅	DLTY
鏺	QWXC
魳	QOGH
岀	MMJ
鮈	QOQK
僀	WAQH
佨	WQNN
癋	UGHN
痋	UJI
岍	MGAH
瞗	HTVO
讇	YUQV
亀	QJJN
堶	FDAE
岼	MGUH
蛥	JQQY
痻	UQAJ
咍	KCKG
剀	MNJH
岎	MWVN
忛	NMYY
鳿	GWVO
躭	TMDQ
霘	FIMK
醎	SGDT
缊	XJLG
挿	RTGH
媜	VHMY
瀹	IWGA
矦	QDTD
熌	OUWY
摋	RQSC
滟	IDHC
齁	THLK
灍	IUUW
繬	XFWK
貇	EEVE
痖	UGOG
営	IPKK
胦	EMDY
槈	SDFF
鸼	TEQG
膟	EYXF
鱯	QOAC
釪	QGFH
釈	TONY
怞	NMG
舖	WFKY
袕	PUPW
罇	RMUF
戣	WGDA
稝	TEEG
埆	FQEH
跠	KHGW
忉	NVN
篧	TPWY
禴	PYWA
硞	DTFK
诤	YQVH
陮	BWYG
懹	NYKE
笶	TTDU
檽	SFDJ
哴	KYVE
礑	DIPL
耇	FTQK
巎	MDHT
鱥	QOHT
雑	VSWY
畀	LGJJ
魞	QOTY
硉	DVFH
亶	YLKG
蓱	AIUA
陼	BFTJ
眂	HQAN
袀	PUQU
褨	PUUA
髲	DEHC
湌	IWYE
腲	ELGE
峘	MGJG
鹶	HLQN
挊	RHGH
疌	GVHI
堐	FDFF
拑	RAFG
垏	FVFH
琔	GPGH
殍	GQEB
脋	VVVE
睰	HADK
媓	VRGG
坮	FCKG
闦	UMAU
鮻	QOCT
涏	ITFP
睂	WWHH
蘨	AERI
衆	TLTI
噏	KWGN
吅	KKG
庅	YTCI
呰	HXKF
暟	JMGU
揋	RLGE
卙	ADWF
蔠	AXTU
兪	WGEB
脁	EIQN
訬	YITT
単	IJFJ
鍖	QADN
鑙	QTDJ
扸	RTHN
眘	DUHF
粭	OWGK
穠	TMAE
亠	YYG
宱	PWTF
淿	IRMH
雡	NWEY
籸	ONFH
枩	SWCU
阬	BYMN
沗	GDIU
襗	PULF
嬛	VLGE
鰎	QOVP
挃	RGCF
嫼	VLFO
鲡	QGGY
帩	MHIE
軳	LQNN
玣	GYHY
唂	KWWK
徴	TMGT
侔	WCRH
垬	FAWY
呪	KKQN
旛	YTTL
铒	QBG
脮	EEVG
痟	UIED
猳	QTNC
獢	QTTK
禜	OOPI
侱	WKGG
羐	GJGY
敮	TFVC
覛	REHQ
臓	EADT
涭	IEPC
瑔	GRIY
戜	AKGD
傤	WFAL
坔	IFF
戫	DEAG
浢	IGKU
誩	YYG
勷	YKKL
裠	VTKE
奰	LLLD
慡	NDQQ
笀	TYNB
楲	SDGT
蘉	ALPC
倁	WTDK
劮	RWLN
甀	TGAN
吤	KWJH
眞	XHNW
蟂	JWVS
罴	LFCO
螾	JPGW
翖	WGKN
奫	DITH
櫮	SGKK
蜭	JQVG
郹	HDBH
秗	TTDY
侰	WVTK
罺	LVJS
籉	TFKF
発	WFQB
鋞	QGVA
晍	JMGK
閮	UTFP
摍	RPWJ
垾	FJFH
敯	NAJC
焵	OMUM
嶖	MWGN
剕	DJDJ
捵	RMAW
竎	UAJ
玏	GLN
贁	MMTY
煇	OPLH
狧	QTTD
鑋	LGVQ
虭	JVN
讄	YLLL
舿	TEDN
詖	YHCY
鶙	UPMO
鎨	QWYF
鎑	QFCL
絿	XFIY
柖	SVKG
琷	GUDN
觹	QEWM
峸	MDNT
痶	UMAW
耠	DIWK
狪	QTMK
凐	USFG
擮	RFAY
奭	DDJJ
鍝	QJMY
酤	SGDG
觱	DGKE
鸇	YLKO
畁	MGJJ
卺	BIGB
膭	EKHM
釸	QQY
槒	SYXL
潫	IUDI
昁	JGMH
殜	GQAS
滃	IWCN
騛	CNUH
擗	RNKU
旑	YDSK
粺	ORTF
鳑	QGUY
檤	SUTP
箲	TITQ
鬦	HGGF
瓛	GHAD
茪	AIQB
藨	AYNO
姈	VWYC
瑿	ATDY
靟	DJDN
枾	SFJG
顔	UTEM
伜	WVFH
咹	KPVG
鉹	QQQY
閰	UVD
缲	XKKS
蠃	YNKY
唊	KDWW
銛	QTDG
臮	THWY
鸓	LLLO
谺	WWKT
螓	JDWT
鐣	QIPR
閙	UYMH
鰡	QOQL
贂	MCCE
茝	AAHH
逌	HLNP
専	GMFU
酭	SGDE
丩	NHK
幨	MHQY
淜	IEEG
廯	YQOD
淍	IMFK
乯	TUHN
鲂	QGYN
溑	IIMY
焭	OOPM
橥	QTFS
輷	LQYG
嗐	KPDK
韕	NHKB
柡	SFIY
悏	NDWW
捤	RNTN
鈩	QYNT
庌	YAHT
椻	SAJV
笇	TYHU
蒄	APFF
熞	OAHF
葻	AMTJ
鏫	QTJS
閇	UGHI
洘	IFTN
齝	HWWK
辁	LWGG
糤	OAET
鮜	QORK
炱	CKOU
壆	WFQF
乢	MNN
猄	QTYI
鼅	TDKV
眱	HGXW
蚚	JRH
瓳	DGNN
挼	REVG
杅	SGFH
趺	KHFW
毵	CDEN
臌	EFKC
鋑	QCWT
繻	XFDJ
猤	QTWD
湨	IHDY
铯	QQCN
鴅	MYWO
倮	WJSY
蛼	JLH
鋉	QGKI
敫	RYTY
鸎	MMWO
扂	YNHK
劬	QKLN
莀	ADFE
彨	GMYE
舧	TETY
鵅	TKWO
鄼	FWFB
虄	AJTG
詯	YTHG
鱠	QOWJ
謍	OOPY
蹧	KHGJ
杘	NSI
譶	YYYF
堸	FMTJ
悇	NWTY
囻	LNAV
欚	SXEJ
讔	YBEN
慐	AMNU
崸	MDMY
俽	WRQW
玪	GWYN
翸	FAMN
塯	FQYL
箥	TIHC
穭	TQOJ
玧	GCQN
膅	EYVK
鏄	QGJF
粿	OJSY
噝	KXXI
罁	RMMM
嘇	KCCE
斲	NNGR
栝	STDG
讠	YYN
糓	FPGC
瘝	ULII
蠳	JMMV
螛	JPDK
舩	TEWC
嫶	VWYO
茈	AHXB
皽	YLKC
臶	GCFB
鴜	HXWO
潱	IFPU
蠛	JALT
縠	FPGC
蠄	JWYC
椞	SRSU
匟	AYMV
俷	WECN
昩	JGSY
銇	QDIY
髨	DEFQ
虉	AGKO
腇	ETVG
灥	RIRI
潠	INNW
忈	FNU
悁	NKEG
攈	RYNT
獧	QTLE
誱	YGVH
欜	SGKE
镢	QDUW
緖	XFTJ
騪	CVHC
緎	XAKG
蚹	JWFY
嶒	MULJ
梖	SMY
鷝	JAFO
樥	SATH
貈	EETE
鎈	QUDA
媭	EDMV
圤	FHY
鹋	ALQG
觡	QETK
貔	EETX
胹	EDMJ
鼳	VNUD
簁	TTHH
噟	YWWK
魆	RQCT
襵	PUBB
朩	SGHY
熛	OSFI
缁	XVLG
忭	NYHY
閊	UMK
嚟	KTQI
挻	RTHP
訁	YYGG
喈	KXXR
卄	AGHH
珎	GQIY
駻	CJFH
籎	TXTH
侲	WDFE
逇	FBPV
闍	UFTJ
粩	OFTX
捖	RPFQ
癎	UUJD
蔁	AUJJ
剻	MEEJ
墿	FLFF
鋚	WHTQ
髴	DEXJ
擶	RTUJ
嵳	MUDA
瘔	UADD
猱	QTCS
痐	ULKD
蛁	JVKG
罬	LCCC
芁	AMB
瑖	GWDC
崤	MQDE
愻	BTXN
慂	ICEN
臐	ETGO
镄	QXJM
漺	IDQQ
呹	KRWY
蒶	AXWV
箆	TMWX
鍂	QQG
荍	ANHT
莮	ALLB
駲	CYTH
朅	FCJN
虡	HAOW
搯	REVG
煪	OUSG
嵰	MUVO
阦	BOY
鍹	QPGG
肬	EDNN
韚	NHKF
鞀	AFVK
顡	UEDM
輲	LMDJ
遡	UBTP
脥	EDWW
羇	LAFK
窲	PWOF
罣	LFFF
湒	IKBG
迨	CKPD
蟭	JWYO
傕	WPWY
豱	EJLG
嬜	UJQV
粓	OAFG
綎	XTFP
鞓	AFKG
镾	DGWQ
戦	IJFA
烺	OYVE
溨	IFAS
紸	XYGG
踽	KHTY
韲	YVUG
灜	IYNY
迓	AHTP
蠮	JATN
鍀	QJGF
纗	XMWK
耖	DIIT
鉣	QFCY
鞢	AFAS
菿	AGCJ
薘	AFUP
笝	TLCU
溂	IGKJ
盺	HRH
杁	STYY
嗘	KEXD
娽	VVIY
曨	JUED
膁	EUVO
尌	FKUF
齭	HWWR
畻	LUDF
嶛	MDUI
鈤	QJG
饤	QNSH
侜	WTEY
傶	WDHT
滫	IWHE
礃	DIPR
閛	UGUH
娡	VFNY
裖	PUDE
秪	TQAY
焈	YNNO
迃	FNPV
驘	YNKY
蔮	ALAG
朥	EOOL
澲	IOGW
啱	KMDG
瞀	CBTH
憽	NAQN
靃	FWYY
劖	QKXJ
鯈	WHTO
刢	WYCJ
瀶	IAHK
帣	UDMH
欋	SHHY
曊	JXJM
豨	EQDH
敃	NATY
慦	FIYN
糆	ODMD
陧	BJFG
呮	KKWY
銙	QDFN
耟	DIAN
蒊	AWXX
磮	DMWA
鬗	DEAY
肙	KEF
僲	WSQH
懓	NEPT
崜	MTGF
埻	FYBG
箓	TVIU
蘜	AAFO
晄	JIQN
樰	SFVG
渳	IXBG
粨	ODJG
驑	CGAL
匲	ADKK
蟍	JTJS
菓	AJSU
泍	ISGG
蒛	ARMW
敨	UKTY
竕	UWVN
箞	TUDB
岋	MEYY
葿	ANHF
曗	JOGW
帢	MHWK
苳	ATUU
楰	SVWY
覮	OOPQ
愪	NKMY
熉	OKMY
楩	SWGQ
獃	MGKD
镻	DRWY
馫	TJTJ
梌	SWTY
嶦	MQDY
瓀	GFDJ
坫	FHKG
頺	TEDM
毾	JNTN
甴	JHK
偒	WJGR
敼	FKUC
鉌	QTY
礀	DUEG
蠌	JLFF
洀	ITEY
觵	QEAW
厗	DUK
姇	WFVF
妀	NVG
縃	XNHE
褦	PUCX
蝯	JEFC
礵	DFSH
顗	MGKM
遤	CPI
楳	SAFS
厾	NFCI
扲	RWYN
岒	MWYN
祾	PYFT
欿	QVQW
痃	UYXI
夒	DHHT
妛	BHGV
玒	GAG
檵	SXXN
朣	EUJF
貹	MTGG
僫	WGHN
軝	LQAN
蒭	AQBT
驺	CQVG
蚎	JJG
粋	OVFH
娖	VKHY
袏	PUDA
嚒	KYSX
櫁	SPNJ
歈	WGEW
羏	UDET
曥	JHAL
駜	CNTT
酁	QKXB
芀	AVB
傁	WVHC
佸	WTDG
唋	KWTY
迬	YGPD
艆	TEYE
阽	BHKG
荝	AMJJ
澏	IKKM
熮	ONWE
褅	PUUH
曓	JBMF
絯	XYNW
韄	AFAC
攴	HCU
傂	WRHM
冭	DUU
頣	AHNM
鷖	ATDO
魒	RQCI
馛	TJDC
娢	VWYK
苘	AMKF
杛	SXN
菚	AAAR
儬	WGEQ
棙	SYND
搼	RUDR
獞	QTUF
鯘	QOTV
侇	WGXW
谠	YIPQ
蕟	AWXC
鞲	AFFF
贆	MDDD
苖	AMF
豯	EEXD
痝	UDNE
簥	TTDK
蝿	JJJN
檼	SEAN
庱	YFWT
朳	SWY
匃	QWNV
鳻	WVWO
穬	TYAW
譨	YMAE
枼	ANSU
庲	YSWW
鸨	XFQG
阠	BNFH
蹢	KHUD
郰	BCBH
宐	PHNG
丮	NFHK
劻	AGLN
嚘	KDET
佡	WWMH
哷	KEFY
顭	ALPM
詷	YMGK
歠	CCCW
唃	KQEH
訮	YGAH
顦	WYOM
甞	IPKF
煑	FTJO
鸈	OGUO
睳	HDFF
肈	YNAH
畎	LDY
夞	QHKX
靎	FQWO
厁	WTUB
恾	NAYN
芗	AXTR
蓣	ACBM
漰	IMEE
遬	GKIP
毇	VOMC
糭	OQOT
艛	TEKV
蟢	JFKK
皉	RHXN
蹅	KHSG
衖	TAWH
堹	FTGF
櫴	SGKM
鼑	HHNN
嵦	MMGU
侌	WYNC
楴	SUPH
儾	WGKE
釿	QRH
鄪	XJMB
褱	YLIE
胬	VCMW
玵	GAFG
昍	JJG
铏	QGAJ
嘋	KFTT
畘	LMFG
茽	AWKH
葊	AWGA
搄	RNGG
杧	SYNN
攺	NTY
膍	ETLX
庈	YWYN
魉	RQCW
蟺	JYLG
桛	SHGH
橉	SOQH
閵	UWYD
薒	AHQO
靊	FDHU
鯎	QODT
鰸	QOAK
緍	XQAJ
铘	QAHB
艞	TETQ
鬿	RQCR
甐	OQAN
眧	HVKG
漷	IYBB
譐	YUSF
吙	KOY
炐	ODHH
嶕	MWYO
瀜	IGKJ
幞	MHOY
臷	FAGF
虩	IJIM
眫	HUFH
偼	WHVH
尥	DNQY
倈	WSWW
羮	UGOY
穘	TFFQ
脎	EQSY
輐	LPFQ
焟	OAJG
鮓	QOTF
伳	WANN
炿	OTMY
俋	WKCN
贌	MOGY
乬	ANNB
嵡	MWCN
鼷	VNUD
恦	NTMK
镸	DGHY
兞	DQTN
狔	QTNX
鵟	QTGO
踼	KHJR
旹	BHGJ
擏	RAQT
狾	QTRR
誋	YNNY
頄	VDMY
縏	TEMI
腍	EWYN
紷	XWYC
珃	GMFG
襷	PUWR
汬	FJIU
疋	NHI
瘶	UGKW
蕦	AEDM
聑	BBG
舗	WFKY
訄	VYD
楶	UQWS
凲	MUVO
焨	OJEG
甙	AAFD
腠	EDWD
搘	RFTJ
桵	SEVG
犲	QTFT
猗	QTDK
鱽	QGVN
栞	GDFS
蔟	AYTD
砃	DMYG
嗹	KLPY
墲	FRLO
蛩	AMYJ
筟	TEBF
庩	YWTI
曷	JQWN
笊	TRHY
禈	PYPL
蘯	AIJL
荬	ANUD
褘	PUNH
鄬	ETNB
矤	XTDY
綯	XQRM
曤	JFWY
哸	KEVG
宲	PKSU
惢	NNNU
穤	TFDJ
躹	TMDO
渪	ITKY
艁	TETK
壝	FKHP
辀	LTEY
礥	DAHM
莤	ASGF
栶	SLDY
賙	MMFK
怊	NVKG
腵	ENHC
臯	THIF
敧	DSKC
霒	FFCN
蕀	AGMI
瀎	IALT
駴	CAAH
褏	YQGE
謟	YEVG
緑	XVIY
僝	WNBB
箵	TITH
齞	HWWW
濿	IDAY
墝	FFFQ
鐦	QUGA
錔	QIJG
灚	IWFQ
齴	HWWE
轺	LVKG
稄	TCWT
瘳	UNWE
磰	DUDK
臫	THNN
獶	QTDT
愥	NAMD
儹	WTFM
墢	FWXC
怇	NANG
卶	QQBH
柲	SNTT
誐	YTRT
鄣	UJBH
抅	RQCY
痥	UUKQ
歳	HDGT
舠	TEVN
緮	XTJT
劁	WYOJ
蚿	JYXY
祃	PYCG
沑	INFG
樚	SYNX
鋈	ITDQ
艢	TEFK
鲝	UDQG
橰	STHF
穜	TUJF
崦	MDJN
韟	NHKF
辶	PYNY
藃	AYMW
簒	THDC
鯳	QOYY
倹	WWGW
燺	OYMS
讋	UEGY
茤	AQQU
拪	RSG
粅	OQRT
繉	XHIQ
饦	QNTA
漋	IBTG
覒	TFNQ
旉	GEHY
棜	SYWU
曻	JQAH
鉯	QNYW
櫹	SAVH
嵯	MUDA
獏	QTAD
驉	CHAG
渿	ISFI
昮	JALB
鹀	AWWG
滝	IUJN
軵	LWFY
鶓	ALWO
惀	NWGA
辝	CKUH
殶	YGMC
蛱	JGUW
衇	TLRE
笜	TBMJ
葅	AWWG
螦	JGXI
歩	HITR
赗	MJHG
餬	WYVE
簰	TTHF
衕	TMGH
嗈	KVKC
逨	SWWP
縼	XYTH
淢	IAKG
詋	YKQN
劧	RLN
蝪	JJGR
毰	TFNK
橠	SYQE
灳	QOI
鳵	NFWO
鼫	VNUD
軅	TMDY
璙	GDUI
昡	JYXY
焹	OMUN
鹴	FSHG
匧	ADWW
檋	SAWL
韔	NHKE
勩	ANML
釟	QWY
瑮	GSSY
栬	SQCN
膯	EWGU
罦	LEBF
惸	NQJB
硟	DTHP
饝	WYVD
蓵	ARGH
橺	SUJG
轇	LNWE
趮	FHKS
酎	SGFY
僤	WKKF
觟	QEFF
栌	SHNT
豴	EUMD
秂	TWU
妋	VFWY
藱	AURC
楖	SVCB
鵖	VCWO
鬂	DERW
涍	IFTB
簕	TAFL
刴	ESJH
盷	HQUG
逿	JGQP
嶆	MGMJ
暷	JGJF
僊	WSDN
蜼	JWYG
檇	SWYN
忕	NDY
姕	HXVF
撯	RUDH
妰	VTHF
幉	MHAS
侁	WTFQ
帠	VMHJ
淾	QIU
窱	PWWS
仠	WFH
盻	HWGN
錖	HICQ
螪	JUMK
纙	XLXY
妟	JVF
鼔	FKUC
幝	MHKF
蕤	AETG
涑	IGKI
柍	SMDY
踥	KHUV
鄜	YNJB
譡	YIPL
蠷	JHHY
湢	IGKL
鳓	QGAL
屟	NANS
塶	FYNX
澣	IFJF
涰	ICCC
銤	QOY
厶	CNY
憌	QQUN
筘	TRKF
弇	WGKA
皹	HCPL
鮶	QOVK
螶	ANJJ
蔀	AUKB
蝥	CBTJ
痏	UDED
裣	PUWI
顋	LNDM
飖	ERMQ
鶥	NHWO
鸂	IEXO
蛫	JQDB
鮤	GQJO
虴	JTAN
醩	SGGJ
潝	IWGN
淂	IJGF
璸	GPGM
鵶	GHGO
洈	IQDB
麇	YNJT
嗀	FPGC
濴	IOOI
錩	QJJG
燻	OTGO
薨	ALPX
箺	TDWJ
鞾	AFAF
玽	GQKG
慙	LRNU
溛	IPWY
幍	MHEV
鱕	QOTL
冸	UUFH
齚	HWWF
妔	VYMN
鹖	JQWG
跾	WHTH
嗸	GQTK
孁	FKKV
琻	GQG
戥	JTGA
桷	SQEH
旜	YTYG
齯	HWWQ
逩	DFAP
榚	SUGO
瘏	UFTJ
鏙	QMWY
劘	YSSJ
霬	FLAW
虨	HASE
鐖	QXXT
娹	VXYX
昷	JLF
輍	LWWK
栣	SWTF
槣	SPDK
栂	SXGU
偓	WNGF
圁	LYD
觧	QEUD
楱	SDWD
飸	KGNE
塳	FTDP
萹	AYNA
樭	SADF
阤	BBN
昚	DUJF
鶆	SWWO
韥	NHKM
佥	WGIF
憁	NTLN
螏	JUTD
傝	WJNG
侫	WYNV
腃	EUDB
觽	QEMM
桪	SVFY
蠂	JAAS
蔖	AHAG
貜	EEHC
儎	WFAL
墣	FOGY
罧	LSSU
豶	EFAM
墱	FWGU
騠	CJGH
萔	ARVK
繄	ATDI
擉	RLQJ
嵱	MPWK
洴	IUAH
禛	PYFW
峜	MWHF
簜	TIJR
匘	XVTQ
硓	DFTX
淏	IJGD
餋	UDWE
眚	TGHF
烼	OEY
牁	NHDK
鐬	QHDT
曐	JJJG
爄	ODAY
跒	KHSK
厪	DAKG
颵	MTJE
醕	SGYJ
暯	JAJD
菪	APDF
鰏	QOGL
潨	ITLI
袺	PUFK
濊	IHDT
碀	DQVH
捰	RJSY
墏	NHDF
崻	MTFF
婰	VMAW
翬	NPLJ
慛	NMWY
餹	WYVK
惤	NXYX
厖	DDNE
溗	ITUX
摗	RGKW
堧	FDMD
藛	APVO
箿	TKBF
噉	KNBT
弸	XEEG
璵	GWFW
徝	TFHG
軉	TMDM
臤	AHNC
帵	MHPB
砞	DGSY
鳽	GAWO
豭	ENHC
釥	QIY
鰅	QOJY
蠤	USGJ
袸	PUDB
俧	WFNY
鍜	QNHC
顀	WYDM
畞	FLQY
鄠	FFNB
悑	NGEY
襘	PUWJ
滗	ITTN
嶮	MWGW
屪	NPDI
裒	YVEU
抩	RMFG
酠	SGSK
愔	NUJG
蠥	BTWJ
蠲	UWLJ
迋	GPD
舎	WFKF
豏	GKUO
乧	UFNB
婠	VPNN
晇	JDFN
羵	UDFM
憭	NDUI
僓	WKHM
騈	CTFF
柾	SGHG
騋	CSWW
鰌	QOUG
嫎	VUPY
罾	LULJ
榾	SMEG
皼	FPGC
钖	QNRT
矠	CBTJ
瑐	GUEJ
璲	GUEP
輮	LCBS
藒	ATJN
臹	GCFT
鬬	HGGR
娬	VGAH
桙	SCRH
贔	MMMU
搰	RMEG
腛	ENGF
拫	RVEY
蕍	AIWJ
奒	DYNW
骔	CPFI
鎷	QCY
皦	RRYT
歁	ADWW
凴	UCMB
鍽	QYNA
偙	WUPH
絙	XGJG
垺	FEBG
氽	WIU
謏	YVHC
魍	RQCN
鱶	QOUE
沕	IQRT
朑	EANN
婟	VLDG
飋	MTJT
趚	FHGI
飬	UDYE
櫏	SSDP
踧	KHHC
筢	TRCB
姡	VTDG
莚	ATHP
堒	FJXX
螔	JRHM
椸	SYTB
鵼	PWAO
紎	XDY
灹	OTAN
馯	CFH
毮	RITN
絸	XHQN
懢	NAHL
恇	NAGG
僙	WAMW
舲	TEWC
觾	QEAO
诜	YTFQ
跏	KHLK
夤	QPGW
嵓	MKKK
黖	LFOQ
歾	GQQR
焎	RROU
艌	TEWN
幮	MHYF
篘	TQBT
厐	DDXV
隃	BWGJ
秅	TTAN
旲	JDU
氻	ILN
鐅	UMIQ
窏	PWIF
賘	MYFY
昢	JBMH
烆	OTFH
冺	UNAN
泚	IHXN
犏	TRYA
杊	SKH
殥	GQPW
戨	SKSA
箽	TTGF
嘙	KIHV
硊	DQDB
撨	RWYO
郳	VQBH
寉	PWYF
儦	WYNO
潎	IUMT
婩	VMDF
昖	JWCY
蘱	AODM
沯	IDF
巈	MAFO
詚	YJGG
俲	WUQL
狜	QTDG
烿	OMYE
猼	QTGF
塅	FWDC
怲	NGMW
逜	GKPD
艩	TEYF
旍	YTWC
薶	AEEF
譄	YULJ
雰	FWVB
飇	MTJD
矰	TDUJ
疅	LGLG
斝	KKPF
鼽	THLV
蠴	JALJ
嚝	KYAW
鐶	QLGE
騉	CJXX
薃	AIYK
圷	FGHY
熜	OTLN
釰	QVYY
桜	SIVG
濦	IEAN
彞	VOXA
楗	SVFP
瞽	FKUH
攟	RYNT
鑻	QSQR
鉐	QDG
儁	WWYM
殎	GQDW
趂	FHQI
蕵	AQWE
秼	TRIY
玕	GFH
襱	PUUD
鲳	QGJJ
枃	SQUG
竚	UPSH
栨	SUQW
稨	TYNA
徛	TDSK
刼	FCVY
怣	RWNU
俻	WTLG
銔	QGIF
涆	IJFH
箳	TNUA
聗	BDWW
铫	QIQN
嗾	KYTD
鐡	QFAU
簎	TRAJ
扨	RVYY
釱	QDY
彳	TTTH
敀	RTY
苿	AFIU
鈓	QTFG
寗	PNTF
葓	AIAW
爎	OPDI
鄡	WVGB
峉	MTKF
貏	EERF
琖	GAAT
榘	TDAS
詀	YHKG
孴	BBBJ
逤	IITP
猌	SWWD
泇	ILKG
鋍	QFPB
傮	WGMJ
夁	FLLD
闇	UUJD
瀔	IFPC
嚄	KAWC
渁	IIIY
镽	DDUI
醦	SGCE
峂	MTUY
瞷	HUJG
檱	STAW
瀒	ISWK
湋	INHH
眮	HMGK
虋	AWFV
沴	IWET
蚄	JYN
縅	XDGT
蕺	AKBT
帨	MHUQ
熇	OYMK
沶	IFIY
趏	FHTD
瘘	UOVD
忰	NVFH
蠎	JADA
蝊	JPGH
紁	XCYY
挵	RGAH
猓	QTJS
賯	MQJB
娝	VGIK
鬤	DEYE
拝	RDFH
疢	UOI
鞟	AFYB
繇	ERMI
襏	PUWC
瓺	DGNN
谮	YAQJ
穒	TWVO
阍	UQAJ
垤	FGCF
訉	YMYY
砮	VCDF
眳	HQKG
軴	LYGG
燨	OUGT
螎	JGKH
爊	OYNO
軠	LTFG
鳘	TXGG
伣	WMQN
攂	RLLL
眅	HRCY
貐	EEWJ
舃	VGNO
曯	JNIJ
鵕	CWTO
珒	GVFH
猘	QTRJ
渽	IFAK
芕	AQU
羉	LXYI
趫	FHTK
鶞	RFHO
叏	NHCU
蛬	AWJU
蓜	ASGN
悺	NPNN
蠜	SQQJ
鈟	QXHH
蹱	KHUF
褌	PUPL
芰	AFCU
帡	MHUA
冡	PGEU
薥	ALQJ
軰	UXLJ
嶘	MSAA
晪	JMAW
輱	LDGT
囐	KHAD
攊	RDTH
戯	HAOA
吺	KMCY
裀	PULD
錇	QUKG
訸	YTY
甊	KGKN
暲	JUJH
嚍	KVHL
溾	IRQC
殽	QDEC
曅	JAGF
蓆	AYAH
蚙	JWYN
籄	TAKM
廮	YMMV
圡	FYI
緕	XYJF
雼	FDF
兤	IQYW
氃	UJFN
嬼	VQYJ
遀	DAEP
烓	OFFG
惥	VWNU
匬	AWGJ
蜽	JGMY
匶	AAWV
裉	PUVE
鞖	AFEV
鄕	XTRB
逧	WWKP
襉	PUUE
謋	YQAS
鲆	QGGH
嵨	MWNO
钷	QAKG
媤	VLNY
壥	FDLF
纞	XXYN
啩	KFFH
蟎	JAMY
楁	SPTK
彶	TEYY
値	WFHN
厸	CCY
酨	FASG
鷞	DQQO
抸	RTPY
溿	ILUF
紾	XWET
宄	PVB
縁	XVEY
鞚	AFPA
咾	KFTX
玝	GTFH
渷	IUKQ
厹	VCU
豛	EMCY
澒	IADM
莯	AISU
摏	RDWV
瑍	GQMD
湁	IRWK
貣	AMU
毭	GKUN
陒	BQDB
袲	YQQE
蘍	ATGL
晣	JRRH
腁	ETFF
騘	CQRN
鑦	QAHM
媨	VUSG
秝	TTY
饡	WYVM
菒	AJSU
璫	GIPL
粰	OEBG
筃	TLDU
癓	UTMT
墸	FAFJ
瘛	UDHN
竁	PWTN
欉	SOGC
捜	RJHC
蚫	JQNN
郬	GEBH
娔	VDQN
儶	WMWK
楬	SJQN
蠁	XTYJ
暵	JAKW
畨	OLF
鑬	QAHQ
哤	KDNE
槶	SLAG
緺	XMNK
喌	KKYH
鏧	FNMQ
凂	UQKQ
淟	IMAW
嚸	KLFK
緵	XQBT
譓	YGJN
跇	KHAN
岦	MUF
枬	SMYG
躢	KHUN
羬	UDDT
獛	QTOY
獽	QTYE
粙	OMG
湅	IGLI
顣	DHIM
坹	FPWY
埯	FDJN
礂	DFKK
魠	QOTA
誖	YFPB
澙	IVGO
逬	TFTP
纋	XDET
糃	OJGR
剾	AKKJ
孮	BPFI
攁	RUDE
殹	ATDC
嶈	MNHF
噂	KUSF
胈	EDCY
絩	XIQN
淉	IJSY
誀	YBG
仫	WTCY
恅	NFTX
挏	RMGK
揔	RQRN
軘	LGBN
磹	DSJH
掍	RJXX
癅	UGAL
縧	XWHS
鱩	QOFL
搮	RSSY
堘	FUDF
斳	AKGR
鋩	QAYN
眊	HTFN
氺	IHYY
鴮	DFNO
駗	CWET
喠	KTGF
斿	YTBG
堥	CBTF
窂	PWRH
艿	AEB
铕	QDEG
燵	OFUP
鄌	YVHB
鏿	QIPS
鴄	AQWO
奿	VYVD
蒤	AIWT
垷	FHQN
毜	TFNI
鶍	JQRO
濥	IQPW
僪	WCBK
郱	UABH
蓚	AWHE
懖	QTDN
嬒	VWGJ
呴	KQKG
鮾	QOEV
驎	COQH
辿	MPK
嬮	DJEV
鰠	QOCJ
煵	OFMF
麞	YNJJ
頕	HKDM
鷉	RHAO
嚠	KQYJ
菄	AGJI
佾	WWEG
鸜	HHWO
碊	DAAT
輣	LEEG
硹	DSWC
衧	PUGF
荘	AUFF
浂	IUDY
伈	WNY
燞	WYQO
咠	KBF
鏐	QNWE
豒	DHDT
渨	ILGE
噅	KETO
讱	YVYY
蚞	JSY
掵	RWGB
氜	RNJF
擵	RYSR
隦	BNKU
唀	KTEN
窼	PWVS
鄑	GOGB
赾	FHRK
嫸	VUDK
郥	MBH
韤	NHKT
灀	IFSH
薾	AGWQ
慹	FUFN
枑	SGXG
菹	AIEG
趼	KHGA
狃	QTNF
侂	WYTA
玬	GMYG
佧	WHHY
萜	AMHK
驈	CCBK
餧	WYVV
詝	YPSH
屄	NPWI
鈪	QDBN
帔	MHHC
怶	NHCY
仦	WIY
烪	OUDY
豷	EFPU
穵	PWNB
歅	SFQW
卨	HMNK
垖	FWNN
玂	QTAR
槹	SRIF
瞙	HAJD
炗	AOU
鄋	VHCB
凚	USSI
甶	TLD
騂	CUH
堗	FPWD
眜	HGSY
棈	SGEG
貗	EEKV
暙	JDWJ
裦	YQGE
剏	UAVY
焒	OKKG
腞	EXEY
菧	AYQY
摐	RTWH
涱	IDEY
畕	LLF
幙	MHAD
曛	JTGO
懻	NUXW
蒴	AUBE
驖	CFAG
綋	XPDC
胪	EHNT
崲	MRGG
曑	JJJE
棯	SWYN
瘿	UMMV
毞	XXTN
嵀	MSYG
菤	AUDB
筓	TFTF
銐	GQJQ
闄	USVD
骵	MESG
劯	DLN
焺	OJTA
幈	MHNA
蟖	JADR
幓	MHCE
鷩	UMIO
樄	SBGI
瓻	QDMN
鰐	QOKN
鳂	QGLE
蛅	JHKG
姀	VTY
艑	TEYA
襚	PUUP
厇	DTAV
螁	JVEP
脴	EGIK
鄟	GJHB
疬	UDLV
咷	KIQN
穛	TWYO
偯	WYEY
娋	VIEG
蛨	JDJG
璓	GATE
飍	MTJJ
鵭	QWVO
鬺	GKMR
棾	SSPM
稦	TNHH
裭	PUHM
椈	SQOY
馲	CTAN
梍	SRAN
鶶	YVHO
埇	FCEH
熤	ONUG
甒	RLGN
諯	YMDJ
鄨	UMIC
鬅	DEEE
槴	SYNC
爂	WFMO
燂	OSJH
帞	MHDJ
桗	SESY
樔	SVJS
顈	XXIM
惂	NQVG
悿	NGDN
誷	YMUN
僌	WLTY
啍	KYBG
刡	NAJH
嗕	KDFF
埳	FQVG
玞	GFWY
櫶	SPDN
蚾	JHCY
匢	AQRE
耼	BMFG
嫯	GQTV
莡	AKHU
礖	DWFW
仧	HWU
胏	ETNT
珸	GGKG
琘	GQAJ
觛	QEJG
衞	TNHH
汃	IWY
煡	OVFP
蔳	AIGE
葜	ADHD
骮	MEAY
窢	PWAG
蟞	UMIJ
弆	FCAJ
旈	YYCQ
扟	RNFH
傽	WUJH
澕	IAGF
偀	WAMD
檈	SLGE
玃	QTHC
狫	QTFX
暡	JWCN
褮	OOPE
醾	SGYO
瀂	IQOJ
泤	INYW
掦	RJQR
鴃	WVGW
潊	IWTC
鯃	QOGK
碡	DGXU
俼	WYCE
篍	TTOU
劔	WGKY
歗	VHTW
馝	TJNT
欔	SHHC
缻	RMGN
筻	TGJQ
諹	YJGR
鍱	QANS
岵	MDG
噡	KQDY
埫	FIMK
褈	PUTF
齎	YVUM
浌	IWAT
鸅	LFUO
垕	RGKF
襋	PUGI
椆	SMFK
旘	YUAJ
鉎	QTGG
馶	CFCY
檭	SQVE
斨	NHDR
鬌	DEDE
絠	XDEG
櫘	SDHN
砟	DTHF
藇	AWFW
蕶	AFWC
霔	FIYG
鴩	RWWO
韍	NHKC
徏	THIT
悝	NJFG
闎	URII
朢	AHNG
嘐	KNWE
鳉	QGUF
餀	WYVQ
裌	PUDW
鬸	GKML
箨	TRCH
镼	DNBM
齍	YVUL
穧	TYVF
熖	OEVG
彄	XAKK
褗	PUAV
岝	MTHF
曵	JXYI
牳	TRXU
叀	GJHC
瀗	IPDN
贃	MKKN
卬	QBH
穕	TWYS
谾	WWKA
枏	SMFG
伱	WWIY
渰	IWGA
榡	SGXI
祫	PYWK
盄	XHLF
榗	SGOJ
儽	WLLI
瞕	HUJH
榌	SNUH
夋	CWTU
廛	YJFF
酑	SGGF
涃	ILSY
憥	OOPN
趓	FHMS
磉	DCCS
鄐	YXLB
鄍	PJUB
玸	GQNN
撽	RRYT
洂	IYOY
恧	DMJN
誢	YHQN
尳	DNME
蠨	JAVH
竮	UNUA
疄	LOQH
顠	SFIM
慞	NUJH
揺	REFB
陎	BRIY
槢	SNRG
龁	HWBN
凞	UTAO
誎	YGKI
緽	XHMY
豇	GKUA
鶐	SYPO
逋	GEHP
抍	RTAH
悢	NYVE
趹	KHNW
椩	SYVW
罆	RMXM
怴	NANT
韝	NHKF
瀳	IAYO
锓	QVPC
獴	QTAE
紏	XUFH
蠼	JHHC
瀪	TXGI
縺	XLPY
鰼	QONR
溠	IUDA
躂	KHFP
鏠	QTDP
炠	OLH
鎽	QMTH
鳫	DWVO
螀	UQFJ
騬	CTUX
綑	XLSY
硋	DYNW
豖	EYI
佒	WMDY
扅	YNQQ
巼	CKXB
甍	ALPN
鸬	HNQG
鲘	QGRK
滼	ISSY
墍	RXAF
坲	FXJH
仏	WCY
皌	RGSY
澚	ITMN
琾	GLWJ
鍧	QQYG
炍	ORCY
旊	YTGN
爈	OHAN
峱	QTNM
醸	SGUE
蘡	AMMV
辥	BTWU
鷅	SSWO
鴐	LKWO
鎾	QJLG
狝	QTQI
夣	YCLQ
瘇	UTGF
琑	GIEG
覢	OOHQ
噖	KGGN
塐	FGXI
苃	ADCU
璶	GVHL
巸	AHKN
跦	KHRI
珢	GVEY
劆	YUVJ
鼢	VNUV
櫇	SHCM
籧	THAP
塀	FNUA
脺	EYWF
覇	SAFE
挍	RUQY
砤	DTBN
繥	XFKK
痮	UDEI
緈	XFUF
燡	OLFF
戺	YNNN
帺	MHAW
獖	QTFM
夆	TDHJ
駽	CKEG
庡	YYEI
泂	IMKG
豦	HAEI
踶	KHJH
訧	YDNN
絰	XGCF
祱	PYUQ
豠	EEGG
刅	VWI
怹	WBNU
侺	WMWN
倸	WESY
椝	FWMS
篟	TWGE
塨	FAWN
邫	DTKC
覜	IQHQ
鱛	QOUJ
亱	YWJG
鉱	QYCY
凊	UGEG
胂	EJHH
戽	YNUF
藯	ANFN
唘	DCKF
阛	ULGE
鈎	QQCY
釨	QBG
蘹	ANYE
錌	QMDF
緢	XALG
嬑	VUJN
譒	YTOL
仈	WWY
墥	FUJF
焄	VTKO
聀	BAT
尟	JGHT
屃	NMI
枅	SGAH
噮	KLGE
鷌	WVGC
倗	WEEG
壛	FUQV
梥	PWCS
乮	QTBN
棼	SSWV
蹨	KHQO
鲀	QGGN
飏	MQNR
誂	YIQN
瞔	HGMY
鷮	TDKO
劙	XEJJ
熻	OWGN
齂	THLI
蟮	JUDK
骾	MEGQ
忢	GNU
敓	WKQT
夅	TAHJ
秔	TYMN
甠	JTGG
炓	OUFH
螿	NHDJ
琯	GPNN
礯	DOOI
髬	DEGG
羱	UDDI
鍲	QNAJ
僈	WJLC
櫋	STHY
楎	SPLH
豓	DHDL
簄	TYNC
欦	WYNW
媖	VAMD
羻	UDYT
愊	NGKL
巕	MUWV
賛	FWFM
詾	YQQB
弰	XIEG
岟	MMDY
緃	XWWH
鯭	QOBL
箒	TVPH
趉	FHBM
鮰	QOLK
玿	GVKG
姃	VGHG
趘	FHNN
觙	QEEY
襇	PUUJ
糫	OLGE
甎	GJHN
柞	STHF
瀻	IFAW
敿	TDKT
枵	SKGN
馎	QNGF
棫	SAKG
憠	DUBN
罖	LWYU
渧	IUPH
橯	SOOL
樏	SLXI
譅	YVYH
炟	OJGG
鉠	QMDY
趍	FHQQ
疓	UEV
钀	QHAD
滪	ICBM
嘃	KYVH
睈	HKGG
泶	IPIU
螆	JUXX
釭	QAG
瀼	IYKE
聮	BXXO
轜	LFDJ
墖	FWGL
壗	FVHL
秺	TPTA
嵟	MDWY
屸	MAG
敒	WJHT
韇	AFFM
怘	DNU
孒	BGD
掲	RJQX
耝	DIEG
偠	WSVG
蓛	AGMT
鞵	AFED
鞸	AFJF
尭	FAQB
饄	WYVF
愹	NPWK
蔶	AGMU
恓	NSG
祡	HXFI
翭	NWND
卥	HLRY
殈	GQTL
皳	FIYC
絑	XRIY
眒	HJHH
勯	YLKL
薤	AGQG
铈	QYMH
濎	IHNN
鮦	QOMK
飜	TOLH
陬	BBCY
姅	VUFH
暳	JDHV
棭	SYWY
竼	TMYU
曒	JRYT
繀	XMWY
膎	EEXD
煈	OMTJ
蝔	JXXR
粬	OMAG
卍	NHGH
栺	SXJG
潄	IGKT
躞	KHOC
昃	JDWU
酺	SGGY
苤	AGIG
葑	AFFF
謢	YWYC
啛	KGVV
瑃	GDWJ
匽	AJVD
姷	VDEG
啿	KADN
聬	BWCN
噀	KNNW
匰	AKKF
覸	UJHQ
懀	NWGJ
詑	YPXN
瑲	GWYK
敜	WYNT
餴	WYVA
廍	YUKB
睭	HMFK
塖	FTUX
嫤	VAKG
屶	MVB
撴	RYBT
蒒	AWNH
趞	FHAJ
厓	DFFD
粴	OJFG
渜	IDMD
蘰	AXJC
鏎	QJAF
鵤	QEWO
蕸	ANHP
懧	NPNS
螇	JEXD
枋	SYN
脜	EDHG
哬	KWSK
妘	VFCY
嶍	MNRG
沤	IAQY
钐	QET
礞	DAPE
趌	FHFK
撜	RWGU
缿	RMRK
栲	SFTN
鱎	QOTK
臅	ELQJ
洿	IDFN
犃	TRUK
戃	NIPO
麿	YSSK
鱣	QOYG
譞	YLGE
獍	QTUQ
瀫	IFPC
壍	ILRF
貛	EEAY
垐	UQWF
鼲	VNUL
埞	FPGH
禚	PYUO
椘	SSPU
鉙	QKWY
衪	PUBN
駞	CTBN
儃	WYLG
貥	MYMN
蟐	JIPH
骬	MEGF
偪	WGKL
媈	VPLH
诰	YTFK
吷	KNWY
釄	SGYD
橀	SYCL
桊	UDSU
埨	FWGA
迼	FKPD
祬	PYGF
銢	QFIY
廤	YLKX
徢	TGVH
鯏	QOTJ
蛪	DHVJ
滈	IYMK
汷	ITY
炈	OMCY
鍳	AHNQ
廀	YPOC
帄	MHSH
慔	NAJD
礅	DYBT
魿	QOWC
檝	SKBT
歱	HTGF
怈	NANN
孆	VMMV
鍐	QQBT
熃	CBTO
繖	XAET
皍	RXBJ
橏	SUDK
忣	NEYY
硱	DLSY
碙	DMUM
钬	QOY
悹	PNHN
鑯	QWWG
澝	IPNE
壀	FNKU
荿	ADNT
痵	UTBD
冄	MFD
霿	FCBH
偖	WFTJ
誃	YQQY
樜	SYAO
絚	XGHG
笭	TWYC
歨	HHU
畉	LFWY
懤	NFNF
牥	TRYN
笓	TXXB
鶎	PFIO
萞	AMWX
癊	UBWC
墷	FAGF
蝀	JGJI
捴	RWCN
騝	CVFP
蠓	JAPE
郮	MFKB
岥	MHCY
倄	WQDE
銶	QFIY
圢	FSH
圞	LXYS
騄	CVIY
鱝	QOFM
鱬	QOFJ
糏	ONIE
毉	ATDW
疂	LIPG
絒	XYTH
醗	SGWQ
矹	DGQN
曞	JDAY
鄚	AJDB
欕	SKKT
峠	MHGH
涹	ITVG
齇	THLG
鬔	DETP
睩	HVIY
鏬	QHAH
膵	EAYF
妕	VKHH
聄	BWET
婤	VMFK
漦	FITI
脃	EQCN
慤	FPMN
镨	QUOJ
歶	HXJY
呄	EDF
瑇	GGXU
蓲	AAKK
猏	QTYE
凙	ULFF
摎	RNWE
兕	MMGQ
骭	MEFH
欭	LDQW
鵌	WVGT
潗	IWYS
軞	LTFN
彚	VPJS
兊	WCQB
蔃	AXKJ
懏	NWYM
缳	XLGE
働	WTGL
劰	RLN
擿	RUMP
萪	ATUF
逈	TMKP
莬	AQKQ
蒢	ABWT
髪	DEDC
鈯	QBMH
鼶	VNUM
贘	MIPM
嬆	VWGN
蒱	ARGY
蒚	AGKH
櫎	SYAW
珟	GMGQ
澟	IYLT
綪	XGEG
棇	SWCN
昽	JDXN
襍	PUWS
繧	XFFC
妢	VWVN
癪	UTGM
絧	XMGK
镦	QYBT
臿	TFVD
撃	LMCR
廔	YKGV
嗗	KMEG
晛	JHQN
鷄	EXDO
佅	WFIY
碕	DDSK
鱦	QOMV
臈	EAJN
墧	FTDK
揟	RNHE
夶	DDY
殠	GQTD
扆	YNYE
玢	GWVN
殂	GQEG
侐	WTLG
鵋	NNWO
挄	RIQN
巠	GVAF
仒	WUU
氒	QAFJ
峀	MMF
驲	CJG
篕	TFCL
笴	TSKF
鴗	UWVO
鋳	QDTF
帍	YNMH
蘶	ATVC
浤	IPDC
搤	RUWL
闟	UWGN
炵	OTUY
鎓	QWCN
噷	KUJW
腙	EPFI
搨	RJNG
糌	OTHJ
鴖	NAWO
穥	TWFW
輼	LJLG
亽	WYU
敇	GMIT
脇	ELLL
涐	ITRT
槔	SRDF
鞥	AFWA
検	SWGW
蓞	AEVF
嘒	KDHV
亻	WTH
餱	WYVD
頫	IQDM
麑	YNJQ
碄	DSSY
蘘	AYKE
腀	EWGA
伌	WDBN
釡	WQF
怸	SYNU
篨	TBWT
娪	VGKG
鈘	QFCY
臔	EAHM
鶂	VQWO
髿	DEIT
惷	DWJN
峩	MTRT
卂	NFK
瞦	HFKK
昲	JXJH
鏻	QOQH
酞	SGDY
鰂	QOMJ
蘟	ABEN
膇	EWNP
鮟	QOPV
乨	CKNN
醓	SGPL
嗿	KWYM
窵	PWWO
蝛	JDGT
詄	YRWY
嬯	VFKF
禸	MCI
鏒	QCCE
琚	GNDG
垻	FMY
垔	SFF
徾	TMYT
虮	JMN
鄷	MAGB
搉	RPWY
帤	VKMH
嵍	CBTM
偐	WUTE
蟽	JFUP
軚	LDYY
棷	SBCY
趛	FHQD
鯐	QOFH
荽	AEVF
俒	WPFQ
揰	RTGF
誫	YDFE
軙	LHCY
嫋	VXUU
衻	PUMF
餙	WYVH
藀	AOOO
雃	GAWY
錷	QLNN
嫏	VYVB
霫	FNRF
蠒	GWMJ
尪	DNGD
尒	WIU
掗	RGHG
崏	MQAJ
鞕	AFGQ
鞝	AFIK
蛢	JUAH
軲	LDG
滒	ISKK
廻	LKPD
猯	QTMJ
躖	KHXG
塄	FLYN
驜	COGW
膤	EFVG
濳	ITFJ
轐	LOGY
噄	KDHI
槾	SJLC
睌	HQKQ
醥	SGSI
黆	AMWQ
斁	LFUT
椖	SYNY
畃	JHQY
掞	ROOY
鳮	CWVO
蒕	ALWL
皭	RELF
鰖	QODE
伖	WDCY
乊	TUR
鳬	WVGM
櫌	SDET
咅	UKF
熰	OAKK
踈	KHGI
镺	DTDY
廙	YLAW
姎	VMDY
穝	TJBC
薎	ALPA
漞	IEHQ
蟘	JWAM
虗	HARG
刔	NWJH
矡	CBTC
魕	RQCT
衸	PUWJ
矼	DAG
睲	HJTG
聭	BRQC
鬫	HGGT
閷	QSUW
栒	SQJG
叝	FCBC
鸖	FWYO
蓌	AWWT
秙	TDG
颿	CMTJ
毦	BTFN
炰	QNOU
葸	ALNU
匤	AGYI
訍	YCYY
拺	RGMI
唟	FCKX
纑	XHAL
棎	SPWS
窸	PWTN
犴	QTFH
儚	WALQ
靕	GHGE
炲	OCKG
齮	HWWK
徔	TAPY
淛	IRMJ
醭	SGOY
葇	ACBS
蝳	JGXU
婥	VHJH
頯	QADM
抲	RSKG
裍	PULS
巃	MUED
夑	OYOT
貊	EEDJ
軏	LGQN
篗	TWYC
檞	SQEH
謤	YSFI
遖	FMUP
襳	PUWG
夌	FWTU
嶨	WFQM
昜	JGQR
淔	IFHG
儫	WYPE
棤	SAJG
薵	AFNF
夊	QYI
荴	ARFW
豰	FPGC
脵	EKGD
跍	KHDG
怓	NVCY
骟	CYNN
襺	PUAJ
蛷	JFIY
蓡	AIVC
斚	CCPF
懳	NDHN
岅	MRCY
鑍	MMQF
鄩	VAKB
簉	TTFP
犨	WYWH
皊	RWYC
縘	XEXD
鏏	QDHV
柃	SWYC
芵	ANWU
蝋	JIMH
鏁	QVJS
榰	SFTJ
碤	DAMD
醰	SGSJ
汔	ITNN
阺	BQAY
孈	VMWK
墕	FGHO
煘	ODGT
虖	HATH
輢	LDSK
麠	YNJG
拠	RTMN
郧	KMBH
蟀	JYXF
鋄	QGOC
嚫	KUSQ
鍡	QLGE
睻	HPGG
簱	TYAW
茐	AQRY
倬	WHJH
觪	QEUH
篬	TWYK
愡	NQRN
陖	BCWT
惌	PQBN
捥	RPQB
湸	IYPM
鱻	QOQO
寖	PIVC
彃	XJAF
麷	SWWU
毟	ITTN
夡	QQFK
狆	QTKH
泒	IRCY
绐	XCKG
胟	EXGU
蘥	AWGA
嫥	VGJF
嗮	KJSG
躨	KHUT
鞔	AFQQ
剹	NWEJ
殀	GQTD
駆	CAQY
叚	NHFC
糽	XSH
乹	FJNN
穸	PWQU
彲	GMYE
毢	TFNS
鵳	YNEO
蒻	AXUU
跕	KHHK
擐	RLGE
殟	GQJL
婬	VETF
碪	DADN
膶	EUGG
鱍	QOWC
奣	GDJE
槑	KSKS
銈	QFFG
寪	PETO
讛	YAFC
漇	ITHH
犳	QTQY
狵	QTDE
镚	QMEE
秖	TQAN
駯	CRIY
髺	DETD
蘎	AFEC
韖	NHKS
﨤	EYYP
氿	IVN
柮	SBMH
湰	ITGG
棏	SJGF
挭	RGJQ
蘳	AAMF
鋺	QPQB
陗	BIEG
錍	QRTF
穁	TABG
菟	AQKY
冖	PYN
幏	MHPE
蹪	KHKM
邶	UXBH
潬	IKKF
懐	NYLE
汿	ICBH
緤	XANS
咵	KDFN
繱	XAQN
濲	IFPC
砱	DWYC
嵂	MTVH
潵	IAET
蚴	JXLN
豼	EEXX
獤	QTYT
紑	XGIY
繺	XQVO
藗	AGKP
盕	IMYL
膡	EUDH
跀	KHEG
鎄	QYEY
禆	PYRF
硂	DWGG
鉨	QQIY
鼀	FWMV
栠	WTFS
扜	RGFH
涴	IPQB
荓	AUAJ
雦	WYWY
緥	XWKS
庳	YRTF
瀖	IFWY
茒	AQBJ
薐	ATFT
椦	SUDL
漗	ITLN
霴	FFCI
謇	PFJY
摃	RAMY
雽	FTUH
硩	RRDF
嵎	MJMY
酼	SGYQ
憕	NWGU
聦	BQRN
敍	WTHC
韊	AFAI
澃	EDMI
蘽	ALLS
銎	AMYQ
濽	IFWM
儏	WHQO
巐	MYMA
吽	KRHH
剟	CCCJ
蹷	DUBH
鐏	QUSF
墋	FCCE
娯	VKNW
畍	LWJH
揧	GKIR
艂	TETH
痄	UTHF
恝	DHVN
囟	TLQI
憆	NIPF
蹫	KHCK
鞺	AFIF
淸	IGMG
笢	TNAB
濏	IGGT
磜	DWFI
袦	PUBM
腪	EPLH
嵕	MQBT
弤	XQAY
粌	OXHH
輏	LSGG
菭	AICK
覠	VTKQ
姢	VCEG
齳	HWWL
埁	FMWN
鐢	SQQQ
屷	MEN
銋	QWTF
捼	RTVG
畤	LFFY
紩	XRWY
猽	QTPU
秵	TLDY
嗙	KUPY
皣	RAGF
墂	FSFI
鼰	VNUM
鷿	NKUO
璷	GGET
轥	LAUY
跿	KHFH
譛	YFWJ
齅	THLD
睔	HWGA
処	TMV
喥	KYAC
碃	DGEG
沝	IIY
磫	DTWH
氭	RNGI
薳	AFKP
埬	FGJI
憦	NOOL
岯	MGIG
暭	JRIF
瘷	UGKT
筫	TMU
羛	UGXJ
颡	CCCM
蹁	KHYA
捪	RQAJ
喤	KRGG
濉	IHWY
娫	VTHP
甁	TFTN
锽	QRGG
癍	UGYG
箝	TRAF
舨	TERC
篌	TWND
溷	ILEY
蟥	JAMW
萻	AUJF
铷	QVKG
怳	NKQN
垱	FIVG
笘	THKF
蓧	AWHS
踿	KHTO
淓	IAYN
蠸	JAKY
锍	QYCQ
翾	LGKN
醢	SGDL
燹	EEOU
塍	EUDF
礡	DAGF
瀞	IGEH
琹	GGSU
恚	FFNU
踭	KHQH
痱	UDJD
牼	TRGA
鼗	IQFC
卣	HLNF
獯	QTTO
牻	TRDE
妫	VYLY
僜	WWGU
罍	LLLM
鋬	RRCQ
鐎	QWYO
垞	FPTA
吢	NKF
箸	TFTJ
誜	YCWT
煺	OVEP
醣	SGYK
朓	EIQN
敎	QDBT
仸	WTDY
涠	ILFH
秏	TTFN
瀍	IYJF
熕	OAMY
蒯	AEEJ
嗞	KUXX
牞	TRLN
祗	PYQY
籀	TRQL
讬	YTAN
仉	WMN
氪	RNDQ
坩	FAFG
疃	LUJF
聼	NBFN
欐	SGMX
镊	QBCC
儋	WQDY
沆	IYMN
坃	FFQN
灬	OYYY
蕖	AIAS
鲱	QGDD
県	HNIU
屦	NTOV
筺	TAGY
濵	IPNM
嘧	KPNM
萘	ADFI
珖	GIQN
诔	YDIY
岣	MQKG
溦	IMGT
髀	MERF
绹	XQRM
滹	IHAH
峁	MQTB
肭	EMWY
嗪	KDWT
曁	RXAG
靺	AFGS
鞨	AFJN
孓	BYI
埜	SSFF
栃	SRDN
渋	IHIY
鋕	QFNY
蛯	JFTX
嘠	KDEA
魨	QOGN
垟	FUDH
诂	YDG
绱	XIMK
舾	TESG
奀	GIDU
犚	NFIH
爰	EFTC
牸	TRPB
犕	TRAE
犝	TRUF
斠	FJGF
臁	EYUO
晷	JTHK
潖	IGGC
醨	SGYC
籓	TITL
湩	ITGF
枱	SCKG
儍	WQOT
瘌	UGKJ
鳀	QGJH
琣	GUKG
湙	IYOD
嚅	KFDJ
綫	XAAT
榊	SPYH
坣	IPFF
溽	IDFF
瑗	GEFC
菽	AHIC
裼	PUJR
髍	MEYS
缷	RMBH
狨	QTAD
舂	DWVF
幪	MHAE
跽	KHNN
墼	GJFF
亊	GUVH
鮣	QOQB
澔	IRTK
胝	EQAY
瓿	UKGN
櫜	GKHS
郯	OOBH
捽	RYWF
锳	QAMD
肀	VHK
犐	TRTF
刂	JHH
瘭	USFI
坌	WVFF
昤	JWYC
醑	SGNE
芏	AFF
埽	FVPH
帀	GMHK
牤	TRYN
茞	AAHH
稘	TADW
釆	TOI
姒	VNYW
嫫	VAJD
乇	TAV
匚	AGN
瞓	HYKH
墁	FJLC
嶯	MKBT
籝	TYNY
欤	GNGW
乩	HKNN
鞪	CBTF
鶀	WVGW
髧	DEPQ
貒	EEMJ
薋	AUQM
鳦	WVGN
莐	AIPQ
隚	BIPF
鞽	AFTK
莇	AEGL
麣	YNJT
閯	UIIT
螤	YJJW
鯥	QOFF
黦	LFOB
諥	YTGF
誸	YXYX
胩	EHHY
黥	LFOI
貕	EEED
铦	QTDG
趤	FHPD
鮸	QOQQ
鯩	QOWA
麊	OYNX
貀	EEBM
莿	AGMJ
鋥	QKGG
膼	EMNP
鯦	QOTK
鎻	QVMY
蒵	AEXD
肻	HPEF
駩	CWGG
苨	ANXB
钁	QHHC
鶢	EFTO
蟩	JDUW
膓	ETJR
鮿	QOBN
鏥	QPWJ
覎	HQBD
隵	BHAA
袐	PUNT
薙	ATDY
袾	PURI
趆	FHQY
袹	PUDJ
膞	EGJF
馦	TJUO
躾	TMDD
瑡	GWNH
麢	YNJK
撠	RFJA
鎟	QCCS
髩	DEGN
醧	SGAK
薆	AEPT
鮳	QOFN
閳	ULK
鞮	AFJH
菥	ASRJ
醏	SGFJ
醖	SGJL
麮	SWWC
覧	AHNQ
麛	YNJB
螌	TEMJ
峣	MATQ
冮	UAG
栊	SDXN
匏	DFNN
暋	NATJ
峃	IPMJ
鹱	QYNC
祢	PYQI
沄	IFCY
甡	TGTG
嗰	KWLD
掹	RBLG
僷	WAAS
赪	FOHM
澴	ILGE
骓	CWYG
禊	PYDD
燿	ONWY
鎭	QXHW
盓	IGFL
樘	SIPF
磔	DQAS
砗	DLH
潲	ITIE
垵	FPVG
琁	GTNH
蝤	JUSG
瓠	DFNY
丿	TTLL
砯	DYIY
钅	QTGN
硭	DAYN
敶	BGJT
犉	TRYB
璕	GVAF
暼	UMIJ
煹	OFJF
珰	GIVG
撛	ROQH
菝	ARDC
斢	AMWF
哚	KMSY
猞	QTWK
貘	EEAD
踅	RRKH
烚	OWGK
煱	OMNK
瑱	GFHW
曩	JYKE
媟	VANS
酦	SGNY
崁	MFQW
昰	JGHF
巣	IJSU
鶤	PLWO
燋	OWYO
馓	QNAT
傚	WUQT
鲃	QGCN
酆	DHDB
堋	FEEG
靑	GMHG
鈡	QKHH
匋	QRMK
廦	YNKU
怱	QRYN
箹	TXQY
隰	BJXO
窅	PWHF
嫲	VYSS
瓘	GAKY
渂	IJYY
攅	RFWM
坼	FRYY
瑭	GYVK
踦	KHDK
玚	GNRT
忞	YNU
堦	FXXR
犙	TRCE
熎	OERM
颕	XFIM
鬏	DETO
篔	TKMU
筜	TIVF
烝	BIGO
翃	DCNG
慓	NSFI
舥	TECN
癑	UMAE
浭	IGJQ
韡	NHKF
筦	TPFQ
顸	FDMY
菰	ABRY
渫	IANS
锠	QJJG
浞	IKHY
鏰	QMEE
誔	YTFP
圏	LUDN
袛	PUQY
嚢	GKHE
舋	WFMG
笤	TVKF
誽	YVQN
伝	WFCY
萩	ATOU
蚜	JAHT
獉	QTDT
赑	MMMU
茛	AVEU
蒗	AIYE
镅	QNHG
惪	FHNU
桡	SATQ
蚋	JMWY
倥	WPWA
蓭	AYDN
骉	CCCF
鮎	QOHK
乸	BXGU
浯	IGKG
乂	QTY
頴	XFIM
袚	PUDC
锿	QYEY
旰	JFH
谯	YWYO
嵚	MQQW
瞢	ALPH
簟	TSJJ
搾	RPWF
輗	LVQN
轁	LEVG
湉	INTD
胘	EYXY
琸	GHJH
溍	IGOJ
庀	YXV
蠧	FPDJ
楦	SPGG
锖	QGEG
猊	QTVQ
囲	LFJK
醅	SGUK
閧	UAWI
俆	WWTY
姘	VUAH
屙	NBSK
圉	LFUF
筌	TWGF
櫈	SWGM
絍	XWTF
攠	RYSD
畋	LTY
虙	HANT
塩	FTKL
灦	IJXM
狯	QTWC
濣	IFJF
瘥	UUDA
蟳	JVAF
潩	ILAW
凉	UYKI
澥	IQEH
猇	QTHM
遆	UPMP
吿	RHKF
菫	AGKG
娕	VGKI
毑	XGUB
蔵	ADAT
阼	BTHF
倳	WGKH
啋	KESY
摛	RYBC
冧	PSSU
鑚	QFWM
曚	JAPE
眇	HITT
橐	GKHS
牖	THGY
汆	TYIU
熑	OUVO
葎	ATVH
姌	VMFG
桕	SVG
覤	HAMQ
丏	GHNN
敭	JGQT
潻	ITWI
怗	NHKG
聱	GQTB
礕	NKUD
錱	QGGF
挌	RTKG
遄	MDMP
襞	NKUE
堠	FWND
弎	ADD
珥	GBG
鲐	QGCK
旄	YTTN
馇	QNSG
脗	EQRK
镎	QWGR
揲	RANS
埌	FYVE
鈠	QMCY
邤	RBH
洸	IIQN
磂	DQYL
靿	AFXL
纟	XXXX
伲	WNXN
嗉	KGXI
莩	AEBF
蒟	AUQK
骙	CWGD
镋	QIPQ
粢	UQWO
欵	XTDW
敹	HPTT
斪	QKRH
窣	PWYF
绨	XUXT
漄	IMDF
嫓	VQMX
羑	UGQY
琒	GTDH
渼	IUGD
灐	IOOQ
斣	LQJF
毹	WGEN
埤	FRTF
呁	KQUG
嚵	KQKY
稆	TKKG
瑅	GJGH
剉	WWFJ
浉	IJGH
僾	WEPT
竜	UJNB
揬	RPWD
袿	PUFF
氆	TFNJ
冾	UWGK
襻	PUSR
瑬	IYCY
鬞	DEME
収	NHCY
銭	QDXY
滐	IQAS
霊	FFOG
媄	VUGD
扥	RTAN
兲	GWU
棽	SSWN
敉	OTY
霐	FIXC
遝	LIPI
鍦	QYTB
弽	XANS
屽	MFH
櫡	STFJ
勬	UDXL
璁	GTLN
皟	RGMY
紝	XTFG
幇	FFFH
嶅	GQTM
粠	OAWY
勫	TOLL
鍒	QCBS
勪	TDKL
婂	VRMH
栫	SDHB
憡	NTGI
浼	IQKQ
殑	GQDQ
楀	STKY
屼	MGQN
絾	XDNT
鐪	QHAL
硶	DMWN
囨	LGII
鏀	QHLO
穼	PWSU
岄	MEG
鎴	QTHN
岃	MVYU
鍓	QKBG
槗	SDKK
悓	NHQN
嬭	VGWQ
笂	TVYU
磱	DOOL
崌	MNDG
皝	RGIQ
綔	DFNI
嵈	MEFC
熺	OFKK
寔	PJGH
冨	PGKL
槰	STDP
箣	TGMJ
鏋	QAMY
勭	UJFL
懆	NKKS
洜	TKIU
埄	FTDH
曟	JJJE
笌	TAHT
忓	NFH
摱	RJLC
愬	UBTN
熸	OAQJ
欑	STFM
犱	QTVY
叆	FCEC
崡	MBIB
笎	TFQB
櫤	STUJ
弬	XAHH
庝	YTUI
炴	OMDY
檷	SGWQ
佹	WQDB
庛	YHXV
愩	NAMY
樿	SKKF
鎯	QYVB
楾	SRIY
嚑	KTGO
嫭	VHAH
熼	OLAW
叴	VKF
欓	SIPO
簬	TKHK
鐜	YBTQ
鐞	QVAF
媴	VFKE
嫑	GISV
鍟	QJTG
嶃	MLRH
妧	VFQN
氱	RNJR
悙	NYBH
樆	SYBC
鑳	QPFH
崱	MMJJ
緟	XTGF
壒	FAFL
忋	NNN
鐤	QHNN
姽	VQDB
楃	SNGF
濄	IMNP
箙	TEBC
伅	WGBN
唴	KUDN
涚	IUKQ
崕	MDFF
緷	XPLH
庤	YFFI
愮	NERM
睍	HHQN
鎺	QPYG
拡	RYCY
瘒	UPLK
紶	XFCY
濆	IFAM
瀷	INLW
泭	IWFY
樼	SNBB
潪	ITDJ
嵄	MUGD
瓧	GNYF
偍	WJGH
晫	JHJH
洰	IANG
楋	SGKJ
姞	VFKG
冩	PVQO
亣	YJJ
祴	PYAA
栵	SGQJ
挙	IWRJ
儠	WVLN
弻	XGLX
竵	UGKH
椾	SUEJ
簹	TIPL
皬	RFWY
棶	SSWW
紒	XWJH
嫢	FWHV
悆	WTNU
紮	SNXI
惣	TRQN
佴	WBG
屇	NLD
咜	KPXN
埈	FCWT
觳	FPGC
皁	RFJ
芶	AQCU
砑	DAHT
涥	IYBH
戡	ADWA
蒎	AIRE
鐾	NKUQ
罝	LEGF
芟	AMCU
濞	ITHJ
幵	FTFH
鶧	AMDO
髟	DET
妑	VCN
窆	PWTP
窰	PWEM
舄	VQOU
丂	GNV
倝	FJWY
蝨	NFJJ
唵	KDJN
図	LUQI
闬	UFK
鋻	AHNQ
捁	RTFK
汯	IDCY
脕	EQKQ
犘	YSSH
聽	BGFN
湴	IUOG
闃	UHDI
鍥	QDHD
鍛	QWDC
樹	SFKF
鑷	QBBB
箰	TQJB
禌	PYUX
嬪	VPGM
鐨	QXJM
鏈	QLPY
鏃	QYTD
績	XGMY
鐐	QDUI
鈥	QOY
滅	IDGT
憺	NQDY
堝	FMNK
熶	OJBC
氳	RNLL
簡	TUJF
緱	XWND
繕	XUDK
浖	IEFY
暀	JTYG
冪	PAJH
閭	UKKD
鎵	QPEY
旽	JGBN
欮	UBTW
辚	LOQH
餸	WYVP
蹝	KHTH
哳	KRRH
艏	TEUH
僦	WYIN
橞	SGJN
犼	QTBN
愄	NLGE
廴	PNY
睺	HWND
瞖	ATDH
隩	BTMD
貃	EERG
嚁	KNWY
皗	RMFK
嗱	KWGR
碥	DYNA
牶	UDRH
簠	TGEL
瞴	HRLO
榍	SNIE
忺	NQWY
筯	TEGL
迵	MGKP
碔	DGAH
褧	BOYE
稩	TLEG
燔	OTOL
贑	UJAM
鄅	TKMB
觍	MAWQ
岞	MTHF
蘩	ATXI
廼	SPD
詃	YYXY
毪	TFNH
熴	OMJX
鳊	QGYA
磻	DTOL
廋	YVHC
濩	IAWC
鹡	IWEG
俛	WQKQ
壵	FFFF
昐	JWVN
嫪	VNWE
毐	FXDR
烣	ODOY
煷	OYPM
騃	CCTD
狢	QTTK
鯾	QOWQ
壊	FFLE
綄	XPFQ
崋	MGAF
冿	UVFH
蓇	AMEF
胠	EFCY
踘	KHQO
蕰	AIJL
啔	YNAK
鬶	FWMH
僸	WSSI
玓	GQYY
堙	FSFG
畱	GAJL
崝	MGEG
鵷	PQBO
襜	PUQY
肧	EGIY
慒	NGMJ
詽	YFTF
蟅	JYAO
饣	QNB
飱	GQWE
穈	YSST
遘	FJGP
匜	ABV
棐	DJDS
檏	SOGW
藙	AUEC
吘	KTFH
倐	WHTO
鍯	QQRN
揷	RTFV
谹	WWKC
礌	DFLG
焌	OCWT
櫣	SALP
硑	DUAH
驒	CKKF
丷	UYT
萛	AHAJ
磒	DKMY
洨	IUQY
菼	AOOU
蓢	AYVE
斀	LQJC
苠	ANAB
擥	AHNR
鶬	WYVO
